id,judet,total_someri,total_femei,total_barbati,indemnizati,neindemnizati,rata_somaj,rata_somaj_femei,rata_somaj_barbati,total_urban,femei_urban,barbati_urban,total_rural,femei_rural,barbati_rural,fara_studii,invatamant_primar,invatamant_gimnazial,invatamant_liceal,invatamant_post,invatamant_profesional,invatamant_universitar,sub_25,25_29,30_39,40_49,50_55,peste_55,month,year
517, ALBA,5356,2430,2926,1811,3545,3.18,3.14,3.23,1921,973,948,3435,1457,1978,655,796,1577,1082,60,892,294,630,314,1080,1470,932,930,1,2020
518, ARAD,2367,1215,1152,858,1509,1.11,1.27,0.97,916,474,442,1451,741,710,235,529,555,520,39,294,195,344,108,290,636,475,514,1,2020
519, ARGES,8094,3771,4323,2437,5657,3.12,3.07,3.16,1449,815,634,6645,2956,3689,674,1858,2560,1274,125,1214,389,734,429,1592,2288,1581,1470,1,2020
520, BACAU,11107,4464,6643,1778,9329,5.24,4.89,5.5,2640,899,1741,8467,3565,4902,2177,771,1139,2663,107,3987,263,1129,516,1755,3077,2132,2498,1,2020
521, BIHOR,3972,2203,1769,2071,1901,1.5,1.82,1.23,1316,790,526,2656,1413,1243,239,693,888,1027,92,583,450,410,218,731,1178,765,670,1,2020
522, BISTRITA NASAUD,3482,1705,1777,1625,1857,2.7,2.99,2.47,1106,621,485,2376,1084,1292,202,290,1099,986,71,640,194,517,184,653,825,661,642,1,2020
523, BOTOSANI,3578,1529,2049,983,2595,2.62,2.33,2.9,1238,613,625,2340,916,1424,150,1080,936,610,54,620,128,346,133,516,1002,714,867,1,2020
524, BRAILA,4412,1796,2616,697,3715,3.59,3.24,3.87,1150,563,587,3262,1233,2029,718,1107,1515,375,66,484,147,431,218,751,1274,699,1039,1,2020
525, BRASOV,5148,2293,2855,970,4178,1.96,2.08,1.87,1438,770,668,3710,1523,2187,1024,1243,1286,666,49,569,311,650,316,1114,1274,868,926,1,2020
526, BUZAU,11171,4508,6663,1273,9898,6.51,5.65,7.25,1922,959,963,9249,3549,5700,2230,2376,3717,1097,67,1570,114,753,450,1898,3372,2126,2572,1,2020
527, CALARASI,3200,1497,1703,533,2667,3.52,3.38,3.66,725,348,377,2475,1149,1326,359,838,1075,461,26,385,56,325,135,666,857,581,636,1,2020
528, CARAS-SEVERIN,3351,1508,1843,1008,2343,3.14,3.25,3.05,1446,667,779,1905,841,1064,586,432,687,945,74,437,190,397,168,531,906,653,696,1,2020
529, CLUJ,4465,2306,2159,1460,3005,1.22,1.43,1.05,1914,1127,787,2551,1179,1372,776,426,973,952,107,777,454,567,261,884,1109,950,694,1,2020
530, CONSTANTA,7213,4492,2721,3482,3731,2.47,3.57,1.63,3630,2577,1053,3583,1915,1668,1048,554,1899,2005,83,1180,444,652,283,1184,1987,1532,1575,1,2020
531, COVASNA,2701,1194,1507,545,2156,3.16,3.02,3.28,749,370,379,1952,824,1128,451,1007,609,288,29,256,61,468,196,578,712,347,400,1,2020
532, DAMBOVITA,6432,3073,3359,981,5451,3.35,3.76,3.04,1130,608,522,5302,2465,2837,953,1161,1801,1246,107,920,244,1048,367,1029,1491,1139,1358,1,2020
533, DOLJ,18067,7504,10563,2230,15837,6.79,6.33,7.16,2742,1423,1319,15325,6081,9244,846,5997,5009,3775,121,1948,371,1576,936,3145,5267,3516,3627,1,2020
534, GALATI,10414,4397,6017,1428,8986,5.48,5.07,5.82,1825,973,852,8589,3424,5165,1067,1999,4209,1197,98,1476,368,748,374,1502,3191,2200,2399,1,2020
535, GIURGIU,1624,844,780,390,1234,2,2.23,1.8,347,207,140,1277,637,640,236,286,617,270,18,146,51,175,57,265,391,350,386,1,2020
536, GORJ,4557,2134,2423,1507,3050,3.36,3.46,3.27,1350,728,622,3207,1406,1801,291,298,1394,1230,127,918,299,460,162,717,1270,866,1082,1,2020
537, HARGHITA,5115,2213,2902,1320,3795,3.8,3.73,3.85,1492,756,736,3623,1457,2166,1270,1234,1006,718,84,610,193,790,338,1189,1328,747,723,1,2020
538, HUNEDOARA,5426,2783,2643,2585,2841,3.15,3.39,2.93,3600,1927,1673,1826,856,970,407,374,1253,1600,113,1151,528,565,397,1024,1480,1048,912,1,2020
539, IALOMITA,4225,1807,2418,966,3259,4.52,4.21,4.78,1230,599,631,2995,1208,1787,298,1032,1439,653,44,702,57,383,174,701,1186,824,957,1,2020
540, IASI,8011,3570,4441,989,7022,2.7,2.62,2.78,1202,631,571,6809,2939,3870,536,1541,2678,642,82,2204,328,878,208,1098,2154,1575,2098,1,2020
541, ILFOV,776,451,325,312,464,0.39,0.52,0.28,228,139,89,548,312,236,110,224,148,146,8,63,77,111,39,127,227,139,133,1,2020
542, MARAMURES,5062,2369,2693,1373,3689,2.52,2.57,2.48,2421,1093,1328,2641,1276,1365,138,1709,830,1190,143,704,348,942,331,944,1285,867,693,1,2020
543, MEHEDINTI,6960,2988,3972,1214,5746,6.71,6.12,7.23,1552,772,780,5408,2216,3192,0,1476,3274,1177,60,860,113,551,216,1585,2416,1006,1186,1,2020
544, MURES,15191,8044,7147,1778,13413,1.28,1.36,1.2,1260,644,616,5242,2184,3058,25,141,2641,5162,287,2687,4248,220,1188,3774,4507,2956,2546,1,2020
545, NEAMT,6502,2828,3674,1132,5370,2.76,2.73,2.79,1344,661,683,6266,2592,3674,1076,2333,1596,572,56,673,196,1052,462,1500,1667,897,924,1,2020
546, OLT,7610,3253,4357,1694,5916,4.2,3.93,4.41,1948,1055,893,6783,2736,4047,932,1163,2319,1034,92,1805,265,856,348,1224,2124,1477,1581,1,2020
547, PRAHOVA,8731,3791,4940,1622,7109,5.4,5.1,5.65,2369,1295,1074,4672,2134,2538,1855,725,2790,1786,77,1433,65,809,304,1248,2605,1811,1954,1,2020
548, SALAJ,7041,3429,3612,2625,4416,2.4,2.77,2.13,837,449,388,3488,1354,2134,634,1290,1907,1292,109,1363,446,669,247,1194,2110,1565,1256,1,2020
549, Satu M.,4325,1803,2522,866,3459,4.22,4.02,4.37,667,337,330,3039,1288,1751,313,1186,1146,950,65,494,171,619,330,955,1069,693,659,1,2020
550, SIBIU,3706,1625,2081,534,3172,2.53,2.43,2.61,1117,561,556,2384,1029,1355,559,1374,1051,342,23,277,80,445,243,902,1074,516,526,1,2020
551, SUCEAVA,3501,1590,1911,964,2537,1.78,1.83,1.75,2887,1404,1483,8050,3308,4742,380,1046,853,542,40,416,224,451,227,629,939,562,693,1,2020
552, TELEORMAN,10937,4712,6225,3475,7462,4.72,4.48,4.92,2063,986,1077,7169,2788,4381,579,2397,3140,2083,227,2141,370,1673,676,2054,2912,1676,1946,1,2020
553, TIMIS,9232,3774,5458,1264,7968,6.43,5.37,7.45,1444,817,627,1533,774,759,431,1139,5090,1283,45,1201,43,847,472,1537,2478,1867,2031,1,2020
554, TULCEA,2977,1591,1386,1493,1484,0.85,1.04,0.7,804,453,351,2038,864,1174,206,106,583,878,65,613,526,250,265,541,801,587,533,1,2020
555, VALCEA,2842,1317,1525,806,2036,3.46,3.45,3.47,1589,871,718,3131,1439,1692,0,468,1380,537,0,415,42,412,132,436,858,570,434,1,2020
556, VASLUI,4720,2310,2410,1941,2779,2.96,3.28,2.71,1337,665,672,8981,3459,5522,132,513,984,1296,131,1333,331,452,206,766,1360,1088,848,1,2020
557, VRANCEA,10318,4124,6194,1251,9067,7.66,6.43,8.77,991,476,515,4007,1591,2416,405,1934,4035,1132,70,2687,55,539,301,1630,3491,2144,2213,1,2020
558,BUCURESTI,4998,2067,2931,807,4191,3.68,3.29,4.02,15191,8044,7147,0,0,0,326,1310,1026,754,74,1390,118,473,267,773,1350,1004,1131,1,2020
559,Total TARA ,258917,117302,141615,59078,199839,2.98,2.96,2.99,78527,41140,37387,180390,76162,104228,25529,48456,74714,48438,3415,44518,13847,26347,13196,46712,72998,48706,50958,1,2020
560, ALBA,5482,2441,3041,1918,3564,3.26,3.15,3.35,1959,966,993,3523,1475,2048,645,791,1630,1073,66,964,313,531,318,1107,1548,1000,978,2,2020
561, ARAD,2201,1121,1080,792,1409,1.03,1.17,0.91,851,435,416,1350,686,664,197,535,537,455,39,246,192,244,117,267,615,459,499,2,2020
562, ARGES,8136,3881,4255,2478,5658,3.13,3.16,3.11,1430,833,597,6706,3048,3658,676,1887,2634,1248,117,1208,366,678,422,1579,2334,1626,1497,2,2020
563, BACAU,11332,4569,6763,1776,9556,5.35,5.01,5.6,2722,920,1802,8610,3649,4961,1802,534,1945,2762,102,3912,275,1014,497,1728,3151,2311,2631,2,2020
564, BIHOR,3839,2118,1721,1898,1941,1.45,1.75,1.19,1215,735,480,2624,1383,1241,250,757,836,971,83,541,401,345,199,749,1144,752,650,2,2020
565, BISTRITA NASAUD,3517,1721,1796,1581,1936,2.73,3.02,2.49,1147,650,497,2370,1071,1299,204,290,1104,1003,68,660,188,514,182,663,832,673,653,2,2020
566, BOTOSANI,3371,1460,1911,876,2495,2.47,2.22,2.7,1200,606,594,2171,854,1317,150,1071,844,585,61,558,102,276,112,492,957,682,852,2,2020
567, BRAILA,4355,1773,2582,660,3695,3.54,3.2,3.82,1112,549,563,3243,1224,2019,726,1102,1503,355,63,472,134,398,193,743,1260,721,1040,2,2020
568, BRASOV,5029,2266,2763,942,4087,1.91,2.05,1.81,1409,755,654,3620,1511,2109,998,1242,1271,659,47,508,304,555,306,1112,1266,872,918,2,2020
569, BUZAU,11099,4473,6626,1230,9869,6.46,5.61,7.21,1888,932,956,9211,3541,5670,2228,2367,3688,1098,62,1546,110,720,438,1888,3336,2129,2588,2,2020
570, CALARASI,3136,1488,1648,472,2664,3.45,3.36,3.54,715,350,365,2421,1138,1283,355,826,1030,485,30,356,54,307,128,645,844,564,648,2,2020
571, CARAS-SEVERIN,3324,1514,1810,987,2337,3.11,3.26,3,1434,678,756,1890,836,1054,602,451,689,893,69,423,197,360,169,531,932,634,698,2,2020
572, CLUJ,4357,2258,2099,1401,2956,1.19,1.4,1.02,1870,1144,726,2487,1114,1373,730,490,1040,878,120,709,390,476,287,893,1132,829,740,2,2020
573, CONSTANTA,7048,4392,2656,3352,3696,2.41,3.49,1.59,3548,2521,1027,3500,1871,1629,897,529,1786,1963,82,1320,471,564,286,1167,1930,1530,1571,2,2020
574, COVASNA,2656,1167,1489,500,2156,3.11,2.95,3.24,727,365,362,1929,802,1127,442,1007,610,273,28,239,57,441,200,562,722,343,388,2,2020
575, DAMBOVITA,6364,3025,3339,964,5400,3.31,3.7,3.02,1062,559,503,5302,2466,2836,633,909,1938,1390,134,999,361,858,396,1044,1526,1162,1378,2,2020
576, DOLJ,17999,7516,10483,2177,15822,6.76,6.34,7.11,2717,1414,1303,15282,6102,9180,849,6013,5010,3691,125,1955,356,1512,928,3115,5219,3541,3684,2,2020
577, GALATI,10323,4363,5960,1346,8977,5.43,5.03,5.76,1813,971,842,8510,3392,5118,1083,1997,4238,1089,104,1470,342,682,343,1483,3193,2218,2404,2,2020
578, GIURGIU,1599,820,779,348,1251,1.97,2.16,1.79,329,196,133,1270,624,646,244,289,609,265,18,132,42,178,58,255,381,347,380,2,2020
579, GORJ,4392,2054,2338,1380,3012,3.23,3.33,3.16,1256,690,566,3136,1364,1772,273,287,1398,1171,119,863,281,373,158,706,1233,866,1056,2,2020
580, HARGHITA,4977,2143,2834,1189,3788,3.69,3.61,3.76,1429,710,719,3548,1433,2115,1282,1229,981,658,80,564,183,734,327,1182,1272,736,726,2,2020
581, HUNEDOARA,5546,2873,2673,2431,3115,3.22,3.5,2.97,3678,1991,1687,1868,882,986,411,520,1488,1590,95,976,466,540,343,1021,1606,1139,897,2,2020
582, IALOMITA,4243,1851,2392,942,3301,4.54,4.31,4.73,1213,610,603,3030,1241,1789,300,1036,1469,637,33,710,58,354,172,719,1197,849,952,2,2020
583, IASI,8106,3554,4552,937,7169,2.74,2.61,2.85,1195,612,583,6911,2942,3969,564,1567,2735,629,61,2229,321,824,204,1134,2233,1593,2118,2,2020
584, ILFOV,777,449,328,303,474,0.39,0.52,0.29,228,139,89,549,310,239,106,218,158,144,7,67,77,105,34,135,235,138,130,2,2020
585, MARAMURES,4713,2244,2469,1278,3435,2.35,2.43,2.28,2398,1135,1263,2315,1109,1206,133,1515,830,1112,126,689,308,795,347,884,1242,795,650,2,2020
586, MEHEDINTI,7005,3000,4005,1237,5768,6.76,6.15,7.3,1533,775,758,5472,2225,3247,0,1474,3286,1204,54,876,111,546,230,1590,2427,1017,1195,2,2020
587, MURES,15050,7937,7113,1731,13319,1.27,1.34,1.19,1218,635,583,5182,2155,3027,25,146,2628,5098,292,2660,4201,196,1166,3735,4459,2965,2529,2,2020
588, NEAMT,6400,2790,3610,1092,5308,2.72,2.7,2.74,1307,657,650,6297,2587,3710,1058,2428,1484,542,55,653,180,972,452,1473,1647,925,931,2,2020
589, OLT,7604,3244,4360,1555,6049,4.19,3.92,4.42,1810,955,855,6693,2707,3986,938,1158,2327,1017,91,1832,241,795,323,1257,2139,1504,1586,2,2020
590, PRAHOVA,8503,3662,4841,1489,7014,5.26,4.92,5.54,2292,1268,1024,4562,2112,2450,1824,724,2793,1641,65,1396,60,731,305,1186,2533,1805,1943,2,2020
591, SALAJ,6854,3380,3474,2472,4382,2.34,2.73,2.05,868,491,377,3513,1367,2146,616,1265,1851,1309,99,1280,434,599,237,1180,2069,1528,1241,2,2020
592, Satu M.,4381,1858,2523,916,3465,4.27,4.15,4.37,685,343,342,3048,1283,1765,321,1180,1203,912,62,533,170,581,320,963,1114,741,662,2,2020
593, SIBIU,3733,1626,2107,505,3228,2.55,2.43,2.65,1082,538,544,2447,1052,1395,572,1404,1065,319,24,272,77,439,247,903,1070,535,539,2,2020
594, SUCEAVA,3529,1590,1939,930,2599,1.8,1.83,1.77,2840,1372,1468,8031,3305,4726,391,1078,855,530,40,419,216,452,236,636,950,567,688,2,2020
595, TELEORMAN,10871,4677,6194,3301,7570,4.69,4.45,4.9,2258,1151,1107,7438,3007,4431,621,1928,3444,2046,151,2287,394,1531,695,2046,2959,1695,1945,2,2020
596, TIMIS,9696,4158,5538,1587,8109,6.75,5.91,7.56,1223,690,533,1458,714,744,450,1158,5290,1267,47,1438,46,794,501,1668,2687,1986,2060,2,2020
597, TULCEA,2681,1404,1277,1384,1297,0.76,0.92,0.64,835,462,373,2021,895,1126,329,104,480,759,47,558,404,227,102,536,775,553,488,2,2020
598, VALCEA,2856,1357,1499,782,2074,3.47,3.55,3.41,1509,869,640,3044,1403,1641,0,477,1336,583,0,419,41,400,127,445,751,665,468,2,2020
599, VASLUI,4553,2272,2281,1793,2760,2.85,3.22,2.56,1335,670,665,8873,3407,5466,132,512,1398,1176,127,892,316,377,195,738,1376,1026,841,2,2020
600, VRANCEA,10208,4077,6131,1158,9050,7.58,6.36,8.68,952,466,486,3946,1572,2374,405,1941,3953,889,62,2907,51,456,296,1609,3438,2083,2326,2,2020
601,BUCURESTI,4898,2038,2860,746,4152,3.6,3.24,3.92,15050,7937,7113,0,0,0,327,1290,1820,705,69,581,106,422,230,781,1350,1000,1115,2,2020
602,Total TARA ,256743,116604,140139,56836,199907,2.95,2.94,2.96,77342,40745,36597,179401,75859,103542,24789,47726,77214,47074,3224,43319,13397,23896,12826,46550,73084,49104,51283,2,2020
603, ALBA,5190,2360,2830,2001,3189,3.09,3.05,3.12,1916,966,950,3274,1394,1880,596,671,1544,1099,53,918,309,421,304,1041,1491,1000,933,3,2020
604, ARAD,2234,1153,1081,911,1323,1.04,1.2,0.91,872,464,408,1362,689,673,331,291,598,440,41,309,224,221,120,307,639,460,487,3,2020
605, ARGES,8096,3925,4171,2608,5488,3.12,3.2,3.05,1544,921,623,6552,3004,3548,659,1844,2618,1269,109,1208,389,567,422,1611,2353,1646,1497,3,2020
606, BACAU,10983,4520,6463,1821,9162,5.18,4.96,5.35,2669,897,1772,8314,3623,4691,1745,557,3771,2752,106,1766,286,915,652,2140,2149,2429,2698,3,2020
607, BIHOR,4155,2386,1769,2138,2017,1.56,1.97,1.23,1423,894,529,2732,1492,1240,272,788,923,1035,84,602,451,303,216,844,1240,829,723,3,2020
608, BISTRITA NASAUD,3216,1593,1623,1452,1764,2.49,2.79,2.25,1080,621,459,2136,972,1164,177,259,984,918,64,635,179,406,158,620,779,641,612,3,2020
609, BOTOSANI,3132,1390,1742,779,2353,2.3,2.12,2.46,1122,587,535,2010,803,1207,170,1070,774,507,51,485,75,199,100,461,925,633,814,3,2020
610, BRAILA,4301,1793,2508,664,3637,3.5,3.24,3.71,1139,582,557,3162,1211,1951,724,1068,1495,365,58,452,139,374,196,733,1245,711,1042,3,2020
611, BRASOV,5113,2330,2783,1028,4085,1.95,2.11,1.82,1531,841,690,3582,1489,2093,981,1228,1297,667,51,532,357,522,313,1124,1318,907,929,3,2020
612, BUZAU,10990,4433,6557,1234,9756,6.4,5.56,7.13,1881,927,954,9109,3506,5603,2217,2350,3662,1087,66,1491,117,663,450,1858,3323,2134,2562,3,2020
613, CALARASI,3012,1477,1535,439,2573,3.32,3.33,3.3,689,354,335,2323,1123,1200,350,809,1002,400,30,361,60,267,112,647,820,533,633,3,2020
614, CARAS-SEVERIN,3236,1466,1770,1023,2213,3.03,3.16,2.93,1401,656,745,1835,810,1025,573,425,680,863,60,431,204,311,163,528,912,630,692,3,2020
615, CLUJ,4479,2381,2098,1629,2850,1.22,1.48,1.02,1935,1198,737,2544,1183,1361,677,481,1066,944,113,764,434,417,269,881,1274,897,741,3,2020
616, CONSTANTA,6763,4247,2516,3289,3474,2.31,3.38,1.51,3433,2468,965,3330,1779,1551,868,538,1806,1911,92,1089,459,479,272,1142,1874,1462,1534,3,2020
617, COVASNA,2680,1195,1485,477,2203,3.14,3.03,3.24,738,376,362,1942,819,1123,435,1006,615,292,31,249,52,431,195,576,727,352,399,3,2020
618, DAMBOVITA,6207,2937,3270,893,5314,3.23,3.59,2.96,1040,545,495,5167,2392,2775,631,924,1954,1308,116,938,336,655,393,1052,1570,1156,1381,3,2020
619, DOLJ,17131,7145,9986,1992,15139,6.44,6.02,6.77,2478,1297,1181,14653,5848,8805,827,5795,4802,3399,120,1790,398,1398,861,2962,4960,3399,3551,3,2020
620, GALATI,10247,4367,5880,1464,8783,5.39,5.03,5.69,1861,1018,843,8386,3349,5037,1072,2001,4171,1099,107,1446,351,590,347,1463,3196,2253,2398,3,2020
621, GIURGIU,1640,873,767,386,1254,2.02,2.3,1.77,368,229,139,1272,644,628,232,285,618,305,18,129,53,203,51,258,392,349,387,3,2020
622, GORJ,4314,2096,2218,1522,2792,3.18,3.4,2.99,1290,754,536,3024,1342,1682,269,278,1298,1184,129,839,317,325,160,726,1229,861,1013,3,2020
623, HARGHITA,4843,2167,2676,1222,3621,3.6,3.65,3.55,1396,710,686,3447,1457,1990,1268,1195,963,647,71,528,171,649,311,1151,1282,723,727,3,2020
624, HUNEDOARA,5822,3159,2663,2832,2990,3.38,3.85,2.96,3919,2224,1695,1903,935,968,449,463,1594,1700,88,1032,496,444,360,964,1871,1305,878,3,2020
625, IALOMITA,3996,1795,2201,878,3118,4.27,4.18,4.35,1198,627,571,2798,1168,1630,284,1002,1389,595,28,623,75,300,157,696,1122,788,933,3,2020
626, IASI,7613,3381,4232,876,6737,2.57,2.48,2.65,1107,592,515,6506,2789,3717,548,1533,2648,529,51,2010,294,585,188,1062,2122,1554,2102,3,2020
627, ILFOV,738,418,320,309,429,0.37,0.48,0.28,216,127,89,522,291,231,93,222,142,136,8,60,77,99,30,134,232,125,118,3,2020
628, MARAMURES,4530,2204,2326,1336,3194,2.26,2.39,2.14,2309,1247,1062,2221,957,1264,129,1351,847,1087,117,709,290,702,327,896,1248,773,584,3,2020
629, MEHEDINTI,6923,2911,4012,1170,5753,6.68,5.97,7.31,1546,772,774,5377,2139,3238,0,1474,3285,1151,42,875,96,475,224,1586,2427,1015,1196,3,2020
630, MURES,14996,7908,7088,1885,13111,1.26,1.34,1.19,1176,611,565,4918,2073,2845,22,142,2625,5069,294,2674,4170,176,1189,3693,4473,2949,2516,3,2020
631, NEAMT,6094,2684,3410,1080,5014,2.59,2.59,2.59,1411,747,664,6089,2557,3532,1036,2194,1458,546,69,623,168,883,425,1377,1577,924,908,3,2020
632, OLT,7500,3304,4196,1692,5808,4.13,4,4.25,1792,978,814,6526,2627,3899,902,1157,2314,1003,79,1794,251,632,307,1273,2142,1547,1599,3,2020
633, PRAHOVA,8318,3605,4713,1393,6925,5.14,4.85,5.39,2324,1301,1023,4332,2026,2306,1841,712,2758,1493,62,1353,99,609,304,1209,2490,1800,1906,3,2020
634, SALAJ,6656,3327,3329,2486,4170,2.27,2.69,1.97,800,458,342,3426,1339,2087,568,1151,1815,1303,107,1307,405,504,235,1145,2054,1500,1218,3,2020
635, Satu M.,4226,1797,2429,874,3352,4.12,4.01,4.21,770,415,355,3064,1313,1751,311,1153,1185,858,60,515,144,517,304,946,1079,723,657,3,2020
636, SIBIU,3834,1728,2106,583,3251,2.62,2.58,2.65,1219,638,581,2469,1070,1399,578,1427,1100,342,27,276,84,439,245,922,1103,576,549,3,2020
637, SUCEAVA,3688,1708,1980,1123,2565,1.88,1.97,1.81,2781,1356,1425,7608,3171,4437,394,1073,859,588,51,472,251,434,253,685,1000,613,703,3,2020
638, TELEORMAN,10389,4527,5862,3047,7342,4.49,4.3,4.64,2160,1101,1059,7144,2863,4281,565,2306,2904,1960,169,2162,323,1326,667,2010,2898,1626,1862,3,2020
639, TIMIS,9304,3964,5340,1493,7811,6.48,5.64,7.29,1176,668,508,1273,643,630,434,1103,5118,1151,35,1373,90,714,472,1650,2587,1922,1959,3,2020
640, TULCEA,2449,1311,1138,1320,1129,0.7,0.86,0.57,829,480,349,1971,925,1046,338,139,479,589,41,501,362,206,82,497,751,498,415,3,2020
641, VALCEA,2800,1405,1395,803,1997,3.41,3.68,3.17,1566,904,662,3025,1411,1614,0,439,1279,602,0,422,58,313,222,461,775,586,443,3,2020
642, VASLUI,4591,2315,2276,1821,2770,2.88,3.28,2.56,1314,698,616,8286,3216,5070,125,502,1393,1234,139,881,317,327,201,788,1360,1080,835,3,2020
643, VRANCEA,9600,3914,5686,1069,8531,7.13,6.11,8.05,968,491,477,3885,1574,2311,405,1841,3736,752,53,2772,41,336,249,1380,3267,2043,2325,3,2020
644,BUCURESTI,4853,2065,2788,758,4095,3.57,3.28,3.82,14996,7908,7088,0,0,0,311,1279,1817,724,63,538,121,397,240,795,1326,987,1108,3,2020
645,Total TARA ,250882,115664,135218,57800,193082,2.88,2.92,2.86,77383,41648,35735,173499,74016,99483,24407,46526,77386,45903,3153,39934,13573,20734,12746,46294,71602,48939,50567,3,2020
646, ALBA,4968,2356,2612,2327,2641,2.95,3.04,2.88,1946,1024,922,3022,1332,1690,186,863,1415,1137,87,962,318,306,302,1022,1424,972,942,4,2020
647, ARAD,2478,1344,1134,1365,1113,1.16,1.4,0.96,1090,620,470,1388,724,664,297,264,613,605,57,354,288,215,144,404,713,531,471,4,2020
648, ARGES,8079,4053,4026,3462,4617,3.11,3.3,2.94,1933,1178,755,6146,2875,3271,532,1540,2478,1559,122,1380,468,508,445,1600,2379,1703,1444,4,2020
649, BACAU,10857,4588,6269,2417,8440,5.12,5.03,5.19,2629,912,1717,8228,3676,4552,1701,739,3403,2708,103,1840,363,843,576,1767,2891,2283,2497,4,2020
650, BIHOR,4316,2556,1760,2820,1496,1.63,2.11,1.22,1644,1033,611,2672,1523,1149,215,621,993,1157,90,721,519,284,257,939,1384,827,625,4,2020
651, BISTRITA NASAUD,3295,1723,1572,1738,1557,2.55,3.02,2.18,1247,769,478,2048,954,1094,171,224,1018,1014,62,611,195,332,169,662,834,673,625,4,2020
652, BOTOSANI,3156,1462,1694,916,2240,2.31,2.23,2.4,1209,644,565,1947,818,1129,180,1025,766,557,52,467,109,179,123,488,921,632,813,4,2020
653, BRAILA,4475,1929,2546,804,3671,3.64,3.48,3.77,1291,696,595,3184,1233,1951,741,1080,1526,419,59,485,165,380,195,781,1288,750,1081,4,2020
654, BRASOV,5477,2525,2952,1528,3949,2.08,2.29,1.94,1898,1046,852,3579,1479,2100,979,1181,1311,844,76,637,449,499,342,1208,1448,995,985,4,2020
655, BUZAU,11242,4578,6664,1628,9614,6.55,5.74,7.25,2059,1045,1014,9183,3533,5650,2221,2328,3712,1161,70,1606,144,660,444,1944,3388,2195,2611,4,2020
656, CALARASI,2829,1401,1428,635,2194,3.12,3.16,3.07,743,380,363,2086,1021,1065,326,684,910,432,30,383,64,254,111,604,759,516,585,4,2020
657, CARAS-SEVERIN,2984,1372,1612,1283,1701,2.79,2.96,2.67,1459,690,769,1525,682,843,463,317,558,881,59,467,239,289,160,523,843,594,575,4,2020
658, CLUJ,4786,2600,2186,2104,2682,1.31,1.61,1.07,2218,1395,823,2568,1205,1363,628,427,1088,1250,116,796,481,385,277,1049,1441,909,725,4,2020
659, CONSTANTA,6458,4007,2451,3387,3071,2.21,3.19,1.47,3425,2406,1019,3033,1601,1432,763,443,1725,1810,89,1119,509,418,282,1141,1802,1397,1418,4,2020
660, COVASNA,2880,1329,1551,604,2276,3.37,3.36,3.38,866,451,415,2014,878,1136,478,1042,644,353,36,275,52,434,209,629,804,384,420,4,2020
661, DAMBOVITA,6035,2852,3183,1010,5025,3.14,3.49,2.88,1053,537,516,4982,2315,2667,614,833,1913,1289,99,955,332,494,312,1103,1541,1208,1377,4,2020
662, DOLJ,18140,7876,10264,2996,15144,6.82,6.64,6.96,3199,1826,1373,14941,6050,8891,840,5950,4864,3737,159,2080,510,1621,1061,3620,5427,3513,2898,4,2020
663, GALATI,10350,4501,5849,1837,8513,5.44,5.19,5.66,2021,1162,859,8329,3339,4990,1050,1945,4152,1185,103,1555,360,568,352,1530,3267,2293,2340,4,2020
664, GIURGIU,1763,959,804,555,1208,2.17,2.53,1.85,451,287,164,1312,672,640,233,286,638,376,20,148,62,208,59,292,450,368,386,4,2020
665, GORJ,4069,2040,2029,1810,2259,3,3.31,2.74,1318,798,520,2751,1242,1509,223,222,1125,1231,117,798,353,270,166,743,1165,818,907,4,2020
666, HARGHITA,5087,2370,2717,1570,3517,3.78,4,3.6,1549,823,726,3538,1547,1991,1242,1173,1006,794,77,606,189,615,345,1219,1383,778,747,4,2020
667, HUNEDOARA,6220,3450,2770,3379,2841,3.61,4.2,3.07,4368,2510,1858,1852,940,912,305,476,1594,1935,101,1254,555,578,543,1197,1682,1310,910,4,2020
668, IALOMITA,3782,1756,2026,1018,2764,4.04,4.09,4,1182,649,533,2600,1107,1493,241,920,1267,642,36,611,65,289,158,660,1097,740,838,4,2020
669, IASI,7909,3558,4351,1145,6764,2.67,2.61,2.72,1312,715,597,6597,2843,3754,552,1539,2674,636,69,2095,344,570,208,1129,2217,1660,2125,4,2020
670, ILFOV,657,387,270,325,332,0.33,0.45,0.24,216,127,89,441,260,181,77,194,124,128,8,64,62,75,27,126,203,117,109,4,2020
671, MARAMURES,4216,2045,2171,1354,2862,2.1,2.22,2,2246,1149,1097,1970,896,1074,74,1263,788,979,108,722,282,572,276,924,1066,740,638,4,2020
672, MEHEDINTI,6069,2676,3393,1405,4664,5.85,5.48,6.18,1449,754,695,4620,1922,2698,0,1212,2725,1150,47,819,116,451,284,1340,2102,918,974,4,2020
673, MURES,15186,8030,7156,3027,12159,1.28,1.36,1.2,1339,734,605,4443,1911,2532,21,146,2574,5264,304,2733,4144,184,1408,3621,4479,3019,2475,4,2020
674, NEAMT,5782,2645,3137,1447,4335,2.46,2.56,2.38,1588,915,673,5681,2525,3156,866,1894,1345,650,95,725,207,763,379,1316,1507,935,882,4,2020
675, OLT,7269,3440,3829,2586,4683,4.01,4.16,3.88,1989,1132,857,6584,2696,3888,796,934,2037,1207,106,1912,277,672,315,1280,2161,1458,1383,4,2020
676, PRAHOVA,8573,3828,4745,1820,6753,5.3,5.15,5.43,2790,1642,1148,4433,2120,2313,1937,702,2740,1521,69,1494,110,560,320,1315,2605,1856,1917,4,2020
677, SALAJ,7223,3762,3461,3397,3826,2.47,3.04,2.05,914,541,373,3430,1392,2038,542,1067,1922,1607,123,1476,486,473,291,1313,2252,1671,1223,4,2020
678, Satu M.,4344,1933,2411,1156,3188,4.24,4.31,4.18,967,533,434,3205,1385,1820,295,1103,1202,982,56,524,182,490,302,976,1171,764,641,4,2020
679, SIBIU,4172,1918,2254,783,3389,2.85,2.87,2.83,1504,780,724,2583,1121,1462,666,1463,1154,424,29,336,100,479,256,990,1229,550,668,4,2020
680, SUCEAVA,4087,1901,2186,1498,2589,2.08,2.19,2,2900,1466,1434,7380,3058,4322,404,1084,930,697,65,584,323,435,281,798,1121,690,762,4,2020
681, TELEORMAN,10280,4524,5756,3541,6739,4.44,4.3,4.55,2142,1116,1026,6666,2703,3963,538,1800,3278,1987,168,2140,369,1194,670,2073,2897,1625,1821,4,2020
682, TIMIS,8808,3819,4989,1633,7175,6.13,5.43,6.81,1360,782,578,1403,724,679,404,1032,4706,1004,42,1523,97,666,436,1623,2483,1792,1808,4,2020
683, TULCEA,2763,1506,1257,1766,997,0.79,0.99,0.63,858,505,353,1857,884,973,305,215,504,661,61,595,422,168,135,511,811,567,571,4,2020
684, VALCEA,2715,1389,1326,915,1800,3.3,3.64,3.01,1845,1080,765,3122,1451,1671,0,421,1219,581,0,424,70,292,170,451,763,600,439,4,2020
685, VASLUI,4967,2531,2436,2422,2545,3.11,3.59,2.74,1271,701,570,7150,2752,4398,116,477,1390,1401,131,1089,363,299,211,879,1512,1204,862,4,2020
686, VRANCEA,8421,3453,4968,1217,7204,6.25,5.39,7.04,1033,564,469,3744,1575,2169,291,1376,3135,879,53,2612,75,289,208,1061,2907,1858,2098,4,2020
687,BUCURESTI,4777,2139,2638,1037,3740,3.52,3.4,3.61,15186,8030,7156,0,0,0,275,1167,1785,781,75,560,134,381,222,792,1318,990,1074,4,2020
688,Total TARA ,251944,119111,132833,73667,178277,2.9,3,2.81,83707,46147,37560,168237,72964,95273,22788,43672,74951,49615,3429,42537,14952,19642,13431,47643,73135,49403,48690,4,2020
689, ALBA,4968,2356,2612,2327,2641,2.95,3.04,2.88,1946,1024,922,3022,1332,1690,186,863,1415,1137,87,962,318,306,302,1022,1424,972,942,5,2020
690, ARAD,2478,1344,1134,1365,1113,1.16,1.4,0.96,1090,620,470,1388,724,664,297,264,613,605,57,354,288,215,144,404,713,531,471,5,2020
691, ARGES,8079,4053,4026,3462,4617,3.11,3.3,2.94,1933,1178,755,6146,2875,3271,532,1540,2478,1559,122,1380,468,508,445,1600,2379,1703,1444,5,2020
692, BACAU,10857,4588,6269,2417,8440,5.12,5.03,5.19,2629,912,1717,8228,3676,4552,1701,739,3403,2708,103,1840,363,843,576,1767,2891,2283,2497,5,2020
693, BIHOR,4316,2556,1760,2820,1496,1.63,2.11,1.22,1644,1033,611,2672,1523,1149,215,621,993,1157,90,721,519,284,257,939,1384,827,625,5,2020
694, BISTRITA NASAUD,3295,1723,1572,1738,1557,2.55,3.02,2.18,1247,769,478,2048,954,1094,171,224,1018,1014,62,611,195,332,169,662,834,673,625,5,2020
695, BOTOSANI,3156,1462,1694,916,2240,2.31,2.23,2.4,1209,644,565,1947,818,1129,180,1025,766,557,52,467,109,179,123,488,921,632,813,5,2020
696, BRAILA,4475,1929,2546,804,3671,3.64,3.48,3.77,1291,696,595,3184,1233,1951,741,1080,1526,419,59,485,165,380,195,781,1288,750,1081,5,2020
697, BRASOV,5477,2525,2952,1528,3949,2.08,2.29,1.94,1898,1046,852,3579,1479,2100,979,1181,1311,844,76,637,449,499,342,1208,1448,995,985,5,2020
698, BUZAU,11242,4578,6664,1628,9614,6.55,5.74,7.25,2059,1045,1014,9183,3533,5650,2221,2328,3712,1161,70,1606,144,660,444,1944,3388,2195,2611,5,2020
699, CALARASI,2829,1401,1428,635,2194,3.12,3.16,3.07,743,380,363,2086,1021,1065,326,684,910,432,30,383,64,254,111,604,759,516,585,5,2020
700, CARAS-SEVERIN,2984,1372,1612,1283,1701,2.79,2.96,2.67,1459,690,769,1525,682,843,463,317,558,881,59,467,239,289,160,523,843,594,575,5,2020
701, CLUJ,4786,2600,2186,2104,2682,1.31,1.61,1.07,2218,1395,823,2568,1205,1363,628,427,1088,1250,116,796,481,385,277,1049,1441,909,725,5,2020
702, CONSTANTA,6458,4007,2451,3387,3071,2.21,3.19,1.47,3425,2406,1019,3033,1601,1432,763,443,1725,1810,89,1119,509,418,282,1141,1802,1397,1418,5,2020
703, COVASNA,2880,1329,1551,604,2276,3.37,3.36,3.38,866,451,415,2014,878,1136,478,1042,644,353,36,275,52,434,209,629,804,384,420,5,2020
704, DAMBOVITA,6035,2852,3183,1010,5025,3.14,3.49,2.88,1053,537,516,4982,2315,2667,614,833,1913,1289,99,955,332,494,312,1103,1541,1208,1377,5,2020
705, DOLJ,18140,7876,10264,2996,15144,6.82,6.64,6.96,3199,1826,1373,14941,6050,8891,840,5950,4864,3737,159,2080,510,1621,1061,3620,5427,3513,2898,5,2020
706, GALATI,10350,4501,5849,1837,8513,5.44,5.19,5.66,2021,1162,859,8329,3339,4990,1050,1945,4152,1185,103,1555,360,568,352,1530,3267,2293,2340,5,2020
707, GIURGIU,1763,959,804,555,1208,2.17,2.53,1.85,451,287,164,1312,672,640,233,286,638,376,20,148,62,208,59,292,450,368,386,5,2020
708, GORJ,4069,2040,2029,1810,2259,3,3.31,2.74,1318,798,520,2751,1242,1509,223,222,1125,1231,117,798,353,270,166,743,1165,818,907,5,2020
709, HARGHITA,5087,2370,2717,1570,3517,3.78,4,3.6,1549,823,726,3538,1547,1991,1242,1173,1006,794,77,606,189,615,345,1219,1383,778,747,5,2020
710, HUNEDOARA,6220,3450,2770,3379,2841,3.61,4.2,3.07,4368,2510,1858,1852,940,912,305,476,1594,1935,101,1254,555,578,543,1197,1682,1310,910,5,2020
711, IALOMITA,3782,1756,2026,1018,2764,4.04,4.09,4,1182,649,533,2600,1107,1493,241,920,1267,642,36,611,65,289,158,660,1097,740,838,5,2020
712, IASI,7909,3558,4351,1145,6764,2.67,2.61,2.72,1312,715,597,6597,2843,3754,552,1539,2674,636,69,2095,344,570,208,1129,2217,1660,2125,5,2020
713, ILFOV,657,387,270,325,332,0.33,0.45,0.24,216,127,89,441,260,181,77,194,124,128,8,64,62,75,27,126,203,117,109,5,2020
714, MARAMURES,4216,2045,2171,1354,2862,2.1,2.22,2,2246,1149,1097,1970,896,1074,74,1263,788,979,108,722,282,572,276,924,1066,740,638,5,2020
715, MEHEDINTI,6069,2676,3393,1405,4664,5.85,5.48,6.18,1449,754,695,4620,1922,2698,0,1212,2725,1150,47,819,116,451,284,1340,2102,918,974,5,2020
716, MURES,15186,8030,7156,3027,12159,1.28,1.36,1.2,1339,734,605,4443,1911,2532,21,146,2574,5264,304,2733,4144,184,1408,3621,4479,3019,2475,5,2020
717, NEAMT,5782,2645,3137,1447,4335,2.46,2.56,2.38,1588,915,673,5681,2525,3156,866,1894,1345,650,95,725,207,763,379,1316,1507,935,882,5,2020
718, OLT,7269,3440,3829,2586,4683,4.01,4.16,3.88,1989,1132,857,6584,2696,3888,796,934,2037,1207,106,1912,277,672,315,1280,2161,1458,1383,5,2020
719, PRAHOVA,8573,3828,4745,1820,6753,5.3,5.15,5.43,2790,1642,1148,4433,2120,2313,1937,702,2740,1521,69,1494,110,560,320,1315,2605,1856,1917,5,2020
720, SALAJ,7223,3762,3461,3397,3826,2.47,3.04,2.05,914,541,373,3430,1392,2038,542,1067,1922,1607,123,1476,486,473,291,1313,2252,1671,1223,5,2020
721, Satu M.,4344,1933,2411,1156,3188,4.24,4.31,4.18,967,533,434,3205,1385,1820,295,1103,1202,982,56,524,182,490,302,976,1171,764,641,5,2020
722, SIBIU,4172,1918,2254,783,3389,2.85,2.87,2.83,1504,780,724,2583,1121,1462,666,1463,1154,424,29,336,100,479,256,990,1229,550,668,5,2020
723, SUCEAVA,4087,1901,2186,1498,2589,2.08,2.19,2,2900,1466,1434,7380,3058,4322,404,1084,930,697,65,584,323,435,281,798,1121,690,762,5,2020
724, TELEORMAN,10280,4524,5756,3541,6739,4.44,4.3,4.55,2142,1116,1026,6666,2703,3963,538,1800,3278,1987,168,2140,369,1194,670,2073,2897,1625,1821,5,2020
725, TIMIS,8808,3819,4989,1633,7175,6.13,5.43,6.81,1360,782,578,1403,724,679,404,1032,4706,1004,42,1523,97,666,436,1623,2483,1792,1808,5,2020
726, TULCEA,2763,1506,1257,1766,997,0.79,0.99,0.63,858,505,353,1857,884,973,305,215,504,661,61,595,422,168,135,511,811,567,571,5,2020
727, VALCEA,2715,1389,1326,915,1800,3.3,3.64,3.01,1845,1080,765,3122,1451,1671,0,421,1219,581,0,424,70,292,170,451,763,600,439,5,2020
728, VASLUI,4967,2531,2436,2422,2545,3.11,3.59,2.74,1271,701,570,7150,2752,4398,116,477,1390,1401,131,1089,363,299,211,879,1512,1204,862,5,2020
729, VRANCEA,8421,3453,4968,1217,7204,6.25,5.39,7.04,1033,564,469,3744,1575,2169,291,1376,3135,879,53,2612,75,289,208,1061,2907,1858,2098,5,2020
730,BUCURESTI,4777,2139,2638,1037,3740,3.52,3.4,3.61,15186,8030,7156,0,0,0,275,1167,1785,781,75,560,134,381,222,792,1318,990,1074,5,2020
731,Total TARA ,251944,119111,132833,73667,178277,2.9,3,2.81,83707,46147,37560,168237,72964,95273,22788,43672,74951,49615,3429,42537,14952,19642,13431,47643,73135,49403,48690,5,2020
732, ALBA,5432,2549,2883,2628,2804,3.23,3.29,3.18,2120,1116,1004,3312,1433,1879,484,582,1546,1388,53,1030,349,437,332,1080,1562,1056,965,6,2020
733, ARAD,3327,1895,1432,2059,1268,1.55,1.98,1.21,1521,910,611,1806,985,821,283,283,827,938,96,549,351,325,171,577,993,687,574,6,2020
734, ARGES,9412,4883,4529,4209,5203,3.63,3.98,3.31,2346,1481,865,7066,3402,3664,588,1777,2825,1952,140,1585,545,660,543,1890,2813,1949,1557,6,2020
735, BACAU,10454,4324,6130,2361,8093,4.93,4.74,5.07,2701,930,1771,7753,3394,4359,2149,749,3500,1082,77,1009,1888,882,465,1657,2895,2129,2426,6,2020
736, BIHOR,4239,2566,1673,2994,1245,1.6,2.12,1.16,1720,1083,637,2519,1483,1036,155,440,979,1322,99,745,499,289,296,920,1345,842,547,6,2020
737, BISTRITA NASAUD,3307,1765,1542,1829,1478,2.56,3.1,2.14,1265,801,464,2042,964,1078,137,195,1037,791,56,624,467,311,177,662,858,674,625,6,2020
738, BOTOSANI,3421,1641,1780,967,2454,2.51,2.5,2.52,1350,728,622,2071,913,1158,189,1042,808,651,41,542,148,275,127,518,969,679,853,6,2020
739, BRAILA,4508,1961,2547,876,3632,3.67,3.54,3.77,1312,713,599,3196,1248,1948,760,1075,1534,426,54,490,169,379,198,764,1311,802,1054,6,2020
740, BRASOV,5812,2793,3019,1834,3978,2.21,2.53,1.98,2235,1272,963,3577,1521,2056,932,1141,1336,1088,80,699,536,636,332,1257,1512,1073,1002,6,2020
741, BUZAU,11506,4725,6781,1679,9827,6.7,5.92,7.38,2124,1057,1067,9382,3668,5714,2293,2345,3756,1249,59,1609,195,758,451,1940,3400,2274,2683,6,2020
742, CALARASI,3183,1615,1568,692,2491,3.51,3.65,3.37,862,458,404,2321,1157,1164,344,786,1032,454,33,375,159,265,121,653,889,606,649,6,2020
743, CARAS-SEVERIN,3319,1532,1787,1406,1913,3.11,3.3,2.96,1568,741,827,1751,791,960,480,309,697,813,82,510,428,357,191,558,893,669,651,6,2020
744, CLUJ,5514,3085,2429,2640,2874,1.51,1.92,1.18,2691,1680,1011,2823,1405,1418,552,535,1313,1310,152,957,695,322,302,1242,1588,1200,860,6,2020
745, CONSTANTA,6497,3592,2905,2277,4220,2.22,2.86,1.74,3310,2060,1250,3187,1532,1655,818,519,1240,2010,90,1010,810,1171,296,1112,1531,1143,1244,6,2020
746, COVASNA,3263,1572,1691,810,2453,3.82,3.98,3.68,1105,606,499,2158,966,1192,517,1082,713,469,48,370,64,499,234,705,904,464,457,6,2020
747, DAMBOVITA,6179,2916,3263,1414,4765,3.22,3.57,2.96,1154,616,538,5025,2300,2725,614,835,2006,1244,94,1035,351,538,310,1104,1640,1273,1314,6,2020
748, DOLJ,18996,8234,10762,3120,15876,7.14,6.94,7.3,3423,1940,1483,15573,6294,9279,860,6142,4982,3841,150,2450,571,1733,1113,3621,5440,3666,3423,6,2020
749, GALATI,10768,4730,6038,1931,8837,5.66,5.45,5.84,2228,1280,948,8540,3450,5090,1072,1999,4246,1338,105,1580,428,742,374,1578,3272,2344,2458,6,2020
750, GIURGIU,1944,1050,894,591,1353,2.39,2.77,2.06,510,308,202,1434,742,692,239,280,666,508,16,162,73,315,69,310,440,401,409,6,2020
751, GORJ,4270,2111,2159,1826,2444,3.14,3.42,2.91,1435,841,594,2835,1270,1565,224,213,1187,1240,164,790,452,325,202,732,1205,878,928,6,2020
752, HARGHITA,5244,2451,2793,1590,3654,3.89,4.13,3.7,1616,856,760,3628,1595,2033,1247,1171,1025,911,67,617,206,708,354,1229,1390,812,751,6,2020
753, HUNEDOARA,6380,3635,2745,3703,2677,3.7,4.43,3.05,4447,2637,1810,1933,998,935,305,388,1594,2053,98,1429,513,449,539,1374,1798,1310,910,6,2020
754, IALOMITA,4060,1896,2164,979,3081,4.34,4.42,4.28,1253,694,559,2807,1202,1605,272,1001,1474,597,44,605,67,330,194,687,1129,794,926,6,2020
755, IASI,8446,3910,4536,1513,6933,2.85,2.87,2.84,1577,881,696,6869,3029,3840,572,1569,2778,786,64,2236,441,477,248,1248,2441,1788,2244,6,2020
756, ILFOV,677,377,300,339,338,0.34,0.44,0.26,216,127,89,461,250,211,85,158,118,176,7,73,60,130,29,132,176,121,89,6,2020
757, MARAMURES,4536,2186,2350,1560,2976,2.26,2.37,2.17,2591,1299,1292,1945,887,1058,69,1260,750,1267,115,730,345,847,283,843,1167,806,590,6,2020
758, MEHEDINTI,6328,2809,3519,1490,4838,6.1,5.76,6.41,1671,887,784,4657,1922,2735,0,1254,2815,1230,88,828,113,496,356,1340,2081,957,1098,6,2020
759, MURES,15241,8077,7164,3764,11477,1.28,1.37,1.2,1437,808,629,4083,1772,2311,25,143,2562,5253,302,2756,4200,218,1502,3622,4428,3012,2459,6,2020
760, NEAMT,5520,2580,2940,1625,3895,2.35,2.49,2.23,1537,893,644,4749,2162,2587,757,1587,1274,809,70,751,272,747,353,1210,1433,934,843,6,2020
761, OLT,6286,3055,3231,2244,4042,3.47,3.69,3.27,2068,1202,866,6605,2753,3852,656,707,1755,1037,95,1631,405,523,269,1078,1813,1342,1261,6,2020
762, PRAHOVA,8673,3955,4718,1765,6908,5.36,5.32,5.4,3109,1784,1325,4779,2351,2428,1891,693,2747,1369,126,1391,456,747,301,1242,2560,1885,1938,6,2020
763, SALAJ,7888,4135,3753,3754,4134,2.69,3.34,2.22,1004,600,404,3552,1461,2091,530,1058,2060,1854,130,1598,658,558,322,1411,2394,1897,1306,6,2020
764, Satu M.,4556,2061,2495,1222,3334,4.44,4.6,4.32,1017,530,487,3642,1639,2003,312,1134,1207,1063,58,568,214,574,305,997,1211,790,679,6,2020
765, SIBIU,4659,2169,2490,910,3749,3.18,3.24,3.13,1744,933,811,2565,1153,1412,635,1647,1339,490,22,365,161,558,310,1118,1370,599,704,6,2020
766, SUCEAVA,4309,2086,2223,1918,2391,2.2,2.4,2.03,3346,1739,1607,7389,3243,4146,364,945,986,750,81,694,489,454,275,864,1201,778,737,6,2020
767, TELEORMAN,10735,4982,5753,3865,6870,4.64,4.74,4.55,2098,1128,970,6467,2696,3771,506,1714,3274,2273,137,2086,745,1516,665,2055,2904,1724,1871,6,2020
768, TIMIS,8565,3824,4741,1625,6940,5.96,5.44,6.47,1620,988,632,1600,833,767,394,980,4422,1091,98,1370,210,728,441,1497,2359,1747,1793,6,2020
769, TULCEA,3220,1821,1399,2071,1149,0.92,1.19,0.7,863,504,359,1855,880,975,197,204,621,1016,96,598,488,250,193,596,926,629,626,6,2020
770, VALCEA,2718,1384,1334,788,1930,3.31,3.62,3.03,1996,1128,868,3305,1554,1751,0,447,1155,578,0,411,127,364,135,481,769,579,390,6,2020
771, VASLUI,5301,2682,2619,2301,3000,3.32,3.8,2.94,1281,716,565,5691,2281,3410,126,518,1416,1573,153,1074,441,552,222,847,1532,1239,909,6,2020
772, VRANCEA,6972,2997,3975,1271,5701,5.18,4.68,5.63,1112,629,483,3890,1667,2223,228,1177,2596,619,51,2030,271,342,204,1099,2277,1571,1479,6,2020
773,BUCURESTI,5002,2296,2706,1039,3963,3.68,3.65,3.71,15241,8077,7164,0,0,0,284,1196,1819,636,73,579,415,474,228,830,1329,1074,1067,6,2020
774,Total TARA ,260667,124907,135760,79479,181188,3,3.15,2.87,89824,49661,40163,170843,75246,95597,23145,43280,76017,51545,3664,42541,20475,23261,14032,48680,74148,51197,49349,6,2020
775, ALBA,5672,2736,2936,2834,2838,3.37,3.53,3.24,2318,1236,1082,3354,1500,1854,455,514,1480,1673,63,1087,400,706,329,1073,1561,1058,945,7,2020
776, ARAD,4558,2586,1972,2545,2013,2.13,2.7,1.67,2185,1275,910,2373,1311,1062,323,320,975,1734,98,711,397,1012,226,702,1143,817,658,7,2020
777, ARGES,10383,5470,4913,4714,5669,4,4.45,3.59,2656,1683,973,7727,3787,3940,637,1785,3020,2420,158,1777,586,1063,585,1983,3016,2124,1612,7,2020
778, BACAU,10966,4637,6329,2467,8499,5.17,5.08,5.24,2867,1010,1857,8099,3627,4472,2112,948,3500,1141,89,1110,2066,1493,495,1622,2804,2127,2425,7,2020
779, BIHOR,5187,3095,2092,3204,1983,1.95,2.55,1.45,2083,1294,789,3104,1801,1303,187,606,1077,1801,97,801,618,797,341,1033,1432,936,648,7,2020
780, BISTRITA NASAUD,3828,2139,1689,2158,1670,2.97,3.75,2.35,1431,882,549,2397,1257,1140,136,188,1138,1316,65,766,219,541,214,715,965,731,662,7,2020
781, BOTOSANI,4021,1981,2040,1094,2927,2.95,3.02,2.89,1611,867,744,2410,1114,1296,193,1042,876,1038,60,647,165,664,143,558,1017,751,888,7,2020
782, BRAILA,4653,2033,2620,871,3782,3.78,3.67,3.88,1359,743,616,3294,1290,2004,778,1077,1557,515,57,503,166,498,208,775,1303,806,1063,7,2020
783, BRASOV,6362,3079,3283,2102,4260,2.42,2.79,2.15,2604,1449,1155,3758,1630,2128,975,1117,1395,1415,91,826,543,939,358,1285,1580,1148,1052,7,2020
784, BUZAU,12293,5203,7090,1853,10440,7.16,6.52,7.71,2465,1278,1187,9828,3925,5903,2304,2335,3804,1849,66,1765,170,1374,457,1967,3452,2338,2705,7,2020
785, CALARASI,3740,1930,1810,850,2890,4.12,4.36,3.89,1135,609,526,2605,1321,1284,343,773,1156,805,39,474,150,571,142,717,967,667,676,7,2020
786, CARAS-SEVERIN,3865,1767,2098,1436,2429,3.62,3.81,3.47,1730,816,914,2135,951,1184,574,383,775,1263,74,561,235,611,205,597,983,722,747,7,2020
787, CLUJ,6240,3540,2700,3072,3168,1.7,2.2,1.32,3132,1918,1214,3108,1622,1486,552,566,1383,1611,177,1256,695,334,302,1242,1813,1658,891,7,2020
788, CONSTANTA,6872,3756,3116,2200,4672,2.35,2.99,1.87,3516,2131,1385,3356,1625,1731,756,776,1249,2778,77,700,536,1639,292,1094,1476,1141,1230,7,2020
789, COVASNA,3870,1953,1917,1094,2776,4.53,4.94,4.18,1415,782,633,2455,1171,1284,521,1099,820,828,50,464,88,798,269,792,995,527,489,7,2020
790, DAMBOVITA,6167,2984,3183,1478,4689,3.21,3.65,2.88,1153,643,510,5014,2341,2673,582,640,1903,1568,92,1012,370,878,333,1020,1526,1195,1215,7,2020
791, DOLJ,19131,8387,10744,3117,16014,7.19,7.07,7.28,3549,2030,1519,15582,6357,9225,854,6167,4968,4301,379,2071,391,2084,999,3285,5395,3697,3671,7,2020
792, GALATI,11726,5273,6453,2018,9708,6.17,6.07,6.24,2696,1542,1154,9030,3731,5299,1105,2015,4316,1995,114,1771,410,1557,381,1600,3313,2374,2501,7,2020
793, GIURGIU,2226,1213,1013,647,1579,2.74,3.2,2.33,629,376,253,1597,837,760,245,285,712,721,16,177,70,528,76,312,469,418,423,7,2020
794, GORJ,5073,2493,2580,1956,3117,3.74,4.04,3.48,1740,984,756,3333,1509,1824,269,211,1278,1886,184,882,363,792,233,827,1251,957,1013,7,2020
795, HARGHITA,5730,2809,2921,1858,3872,4.25,4.74,3.87,1912,1035,877,3818,1774,2044,1069,1236,971,1388,75,761,230,1168,354,1230,1398,795,785,7,2020
796, HUNEDOARA,6435,3695,2740,3686,2749,3.74,4.5,3.04,4598,2743,1855,1837,952,885,305,397,1540,2295,119,1194,585,765,360,1008,1960,1496,846,7,2020
797, IALOMITA,4351,2049,2302,1004,3347,4.65,4.78,4.55,1439,761,678,2912,1288,1624,270,1014,1356,949,48,637,77,579,189,668,1161,802,952,7,2020
798, IASI,9037,4304,4733,1769,7268,3.05,3.16,2.96,1825,1013,812,7212,3291,3921,564,1580,2847,1108,82,2351,505,751,240,1284,2568,1881,2313,7,2020
799, ILFOV,851,490,361,391,460,0.42,0.57,0.31,252,147,105,599,343,256,91,143,126,342,7,81,61,279,33,135,188,126,90,7,2020
800, MARAMURES,5312,2618,2694,1761,3551,2.65,2.84,2.48,3292,1688,1604,2020,930,1090,58,1209,763,2031,117,770,364,1437,388,907,1203,816,561,7,2020
801, MEHEDINTI,6695,3050,3645,1596,5099,6.46,6.25,6.64,1859,1012,847,4836,2038,2798,0,1326,2979,1286,89,876,139,542,422,1401,2143,1020,1167,7,2020
802, MURES,15290,8167,7123,4410,10880,1.29,1.38,1.19,1782,1005,777,4285,1982,2303,25,144,2570,5161,302,2839,4249,367,1420,3686,4387,3023,2407,7,2020
803, NEAMT,6067,2987,3080,1920,4147,2.58,2.89,2.34,1803,1021,782,6141,2789,3352,719,1545,1227,1340,75,848,313,1181,344,1208,1501,1002,831,7,2020
804, OLT,7944,3810,4134,2234,5710,4.38,4.61,4.19,2309,1336,973,6979,2938,4041,865,1018,2240,1544,100,1870,307,1019,299,1275,2137,1580,1634,7,2020
805, PRAHOVA,9288,4274,5014,1867,7421,5.74,5.74,5.74,3506,2008,1498,5383,2752,2631,1936,736,2773,2191,149,1461,42,1218,320,1254,2578,1932,1986,7,2020
806, SALAJ,8889,4760,4129,4116,4773,3.03,3.84,2.44,1270,724,546,3805,1595,2210,547,1072,2167,2418,140,1804,741,1160,346,1471,2537,2014,1361,7,2020
807, Satu M.,5075,2319,2756,1371,3704,4.95,5.18,4.78,1111,574,537,3749,1700,2049,326,1131,1228,1520,63,609,198,961,311,1023,1256,807,717,7,2020
808, SIBIU,4860,2274,2586,901,3959,3.32,3.4,3.25,2347,1269,1078,2852,1341,1511,658,1691,1361,588,23,388,151,672,314,1128,1387,636,723,7,2020
809, SUCEAVA,5199,2610,2589,2565,2634,2.65,3,2.37,3723,1958,1765,7840,3573,4267,372,970,1115,1263,94,949,436,701,309,995,1420,943,831,7,2020
810, TELEORMAN,11563,5531,6032,3998,7565,4.99,5.26,4.77,2155,1186,969,6681,2818,3863,437,1569,3071,3489,147,2269,581,2695,644,1924,2823,1653,1824,7,2020
811, TIMIS,8836,4004,4832,1685,7151,6.15,5.7,6.59,1920,1113,807,1800,967,833,402,974,4618,1330,95,1354,63,1064,419,1454,2326,1762,1811,7,2020
812, TULCEA,3720,2080,1640,2232,1488,1.06,1.36,0.82,921,539,382,1871,884,987,198,106,759,1396,99,641,521,594,201,611,946,704,664,7,2020
813, VALCEA,2792,1423,1369,779,2013,3.4,3.73,3.11,2243,1226,1017,3673,1758,1915,0,433,1107,757,0,416,79,457,193,462,694,576,410,7,2020
814, VASLUI,5916,2984,2932,2442,3474,3.71,4.23,3.29,1426,798,628,6372,2585,3787,125,489,1428,2215,158,1119,382,1110,229,844,1541,1239,953,7,2020
815, VRANCEA,7798,3383,4415,1283,6515,5.79,5.28,6.25,1231,671,560,4227,1813,2414,240,1257,2815,1112,62,2228,84,674,239,1151,2389,1732,1613,7,2020
816,BUCURESTI,5458,2484,2974,1052,4406,4.02,3.95,4.07,15290,8167,7123,0,0,0,303,1255,1851,1215,72,592,170,814,242,856,1354,1091,1101,7,2020
817,Total TARA ,283939,138360,145579,86630,197309,3.27,3.49,3.08,100488,55542,44946,183451,82818,100633,23411,44142,78294,69596,4162,45418,18916,39087,14404,49174,76358,53822,51094,7,2020
818, ALBA,5590,2738,2852,2992,2598,3.32,3.53,3.14,2320,1265,1055,3270,1473,1797,430,479,1442,1707,62,1071,399,762,321,1028,1538,1039,902,8,2020
819, ARAD,4798,2782,2016,2867,1931,2.24,2.9,1.7,2243,1313,930,2555,1469,1086,349,337,1018,1813,101,718,462,1058,231,721,1206,884,698,8,2020
820, ARGES,10508,5499,5009,4793,5715,4.05,4.48,3.66,2686,1699,987,7822,3800,4022,649,1859,3012,2411,167,1812,598,1093,602,1987,3003,2167,1656,8,2020
821, BACAU,10881,4703,6178,2835,8046,5.13,5.16,5.11,3025,1333,1692,7856,3370,4486,1778,1172,3098,3212,128,1194,299,1647,477,1539,2611,2008,2599,8,2020
822, BIHOR,5349,3216,2133,3393,1956,2.01,2.65,1.48,2101,1333,768,3248,1883,1365,200,663,1139,1778,100,830,639,855,344,1047,1466,956,681,8,2020
823, BISTRITA NASAUD,3998,2271,1727,2259,1739,3.1,3.98,2.4,1516,917,599,2482,1354,1128,125,172,1177,1425,78,748,273,686,231,713,975,719,674,8,2020
824, BOTOSANI,3991,1987,2004,1245,2746,2.93,3.02,2.83,1577,862,715,2414,1125,1289,196,1020,857,1027,52,648,191,656,148,544,1008,742,893,8,2020
825, BRAILA,4901,2156,2745,997,3904,3.98,3.89,4.06,1474,831,643,3427,1325,2102,793,1122,1599,583,57,561,186,590,218,793,1365,847,1088,8,2020
826, BRASOV,6581,3226,3355,2287,4294,2.5,2.92,2.2,2796,1550,1246,3785,1676,2109,974,1116,1378,1607,96,813,597,1048,373,1301,1595,1170,1094,8,2020
827, BUZAU,12280,5241,7039,2183,10097,7.15,6.57,7.66,2473,1293,1180,9807,3948,5859,2274,2315,3793,1845,73,1792,188,1377,467,1980,3436,2367,2653,8,2020
828, CALARASI,3765,1985,1780,1036,2729,4.15,4.48,3.83,1130,621,509,2635,1364,1271,358,789,1167,801,39,456,155,555,138,732,967,679,694,8,2020
829, CARAS-SEVERIN,3915,1824,2091,1658,2257,3.67,3.93,3.46,1801,872,929,2114,952,1162,551,379,790,1296,91,562,246,667,208,579,982,720,759,8,2020
830, CLUJ,6652,3728,2924,3251,3401,1.82,2.32,1.43,3132,1918,1214,3520,1810,1710,587,617,1468,1772,180,1326,702,443,309,1286,1932,1784,898,8,2020
831, CONSTANTA,7017,3827,3190,2270,4747,2.4,3.04,1.91,3574,2174,1400,3443,1653,1790,844,680,1286,2704,96,748,659,1696,300,1145,1481,1145,1250,8,2020
832, COVASNA,4174,2158,2016,1306,2868,4.89,5.46,4.39,1499,838,661,2675,1320,1355,529,1123,871,930,53,550,118,930,281,827,1053,578,505,8,2020
833, DAMBOVITA,5967,2901,3066,1587,4380,3.11,3.55,2.78,1141,624,517,4826,2277,2549,557,460,1912,1549,91,1022,376,830,330,977,1485,1178,1167,8,2020
834, DOLJ,17467,7641,9826,3058,14409,6.56,6.44,6.66,3247,1880,1367,14220,5761,8459,731,5607,4523,3973,368,1916,349,1804,825,2869,4973,3462,3534,8,2020
835, GALATI,11944,5389,6555,2277,9667,6.28,6.21,6.34,2763,1596,1167,9181,3793,5388,1157,2063,4312,2045,134,1764,469,1656,397,1617,3333,2416,2525,8,2020
836, GIURGIU,2186,1198,988,800,1386,2.69,3.16,2.28,638,391,247,1548,807,741,248,294,664,714,18,166,82,504,77,321,455,403,426,8,2020
837, GORJ,5271,2542,2729,2283,2988,3.88,4.12,3.68,1839,1010,829,3432,1532,1900,273,226,1299,1942,214,923,394,822,238,835,1310,1012,1054,8,2020
838, HARGHITA,6034,3108,2926,2378,3656,4.48,5.24,3.88,2094,1177,917,3940,1931,2009,1186,1040,1086,1435,83,892,312,1297,363,1226,1456,913,779,8,2020
839, HUNEDOARA,6265,3573,2692,3863,2402,3.64,4.35,2.99,4480,2656,1824,1785,917,868,205,397,1493,2260,119,1194,597,734,368,908,1960,1466,829,8,2020
840, IALOMITA,4352,2031,2321,1079,3273,4.65,4.73,4.59,1436,755,681,2916,1276,1640,280,1024,1337,945,52,628,86,604,182,660,1133,804,969,8,2020
841, IASI,9311,4452,4859,1936,7375,3.14,3.27,3.04,1951,1090,861,7360,3362,3998,556,1612,2864,1165,90,2417,607,891,246,1336,2583,1926,2329,8,2020
842, ILFOV,851,490,361,391,460,0.42,0.57,0.31,252,147,105,599,343,256,91,143,126,342,7,81,61,279,33,135,188,126,90,8,2020
843, MARAMURES,5425,2681,2744,2004,3421,2.7,2.91,2.53,3148,1581,1567,2277,1100,1177,63,1153,727,2099,106,839,438,1784,420,776,1106,808,531,8,2020
844, MEHEDINTI,6499,2908,3591,1667,4832,6.27,5.96,6.54,1800,971,829,4699,1937,2762,0,1258,2829,1339,88,847,138,590,376,1357,2098,974,1104,8,2020
845, MURES,15354,8223,7131,4767,10587,1.29,1.39,1.19,1827,1046,781,4198,1953,2245,25,141,2524,5254,302,2795,4313,427,1448,3627,4443,3017,2392,8,2020
846, NEAMT,6025,2999,3026,2130,3895,2.56,2.9,2.3,1772,1010,762,6388,2878,3510,663,1504,1205,1289,89,884,391,1251,349,1156,1449,1007,813,8,2020
847, OLT,8160,3888,4272,2281,5879,4.5,4.7,4.33,2473,1417,1056,7081,3000,4081,877,1050,2295,1603,122,1888,325,1190,319,1244,2145,1603,1659,8,2020
848, PRAHOVA,9554,4417,5137,2008,7546,5.9,5.94,5.88,3525,2031,1494,5564,2817,2747,1990,706,2809,2330,147,1503,69,1414,334,1239,2546,1996,2025,8,2020
849, SALAJ,9089,4848,4241,4471,4618,3.1,3.92,2.51,1289,729,560,3753,1573,2180,563,1076,2157,2521,147,1861,764,1228,381,1522,2543,2016,1399,8,2020
850, Satu M.,5042,2302,2740,1648,3394,4.92,5.14,4.75,1143,601,542,3885,1761,2124,347,1114,1180,1455,69,633,244,970,312,1013,1237,812,698,8,2020
851, SIBIU,5028,2362,2666,949,4079,3.43,3.53,3.35,2477,1351,1126,2964,1383,1581,643,1797,1418,588,25,392,165,725,339,1160,1421,639,744,8,2020
852, SUCEAVA,5441,2734,2707,2707,2734,2.77,3.15,2.48,3833,2016,1817,7887,3632,4255,384,1025,1163,1273,100,1011,485,769,314,1011,1444,1030,873,8,2020
853, TELEORMAN,11720,5648,6072,4298,7422,5.06,5.37,4.8,2039,1146,893,6683,2822,3861,469,1845,2736,3515,203,2374,578,2880,634,1936,2781,1679,1810,8,2020
854, TIMIS,8722,3968,4754,1953,6769,6.07,5.64,6.49,2158,1255,903,1947,1067,880,393,958,4443,1441,102,1317,68,1072,407,1424,2288,1722,1809,8,2020
855, TULCEA,4105,2322,1783,2723,1382,1.17,1.52,0.9,780,460,320,1753,811,942,198,114,862,1510,117,690,614,647,247,703,1037,777,694,8,2020
856, VALCEA,2533,1271,1262,847,1686,3.08,3.33,2.87,2317,1279,1038,3795,1800,1995,0,435,1030,628,0,355,85,482,108,385,692,524,342,8,2020
857, VASLUI,6112,3079,3033,2770,3342,3.83,4.37,3.41,1588,881,707,6693,2722,3971,118,491,1462,2290,173,1138,440,1194,273,847,1569,1259,970,8,2020
858, VRANCEA,8281,3603,4678,1463,6818,6.15,5.62,6.63,1226,662,564,4298,1854,2444,261,1320,2910,1133,70,2483,104,675,246,1159,2478,1957,1766,8,2020
859,BUCURESTI,5524,2516,3008,1214,4310,4.06,4,4.12,15354,8223,7131,0,0,0,329,1288,1870,1194,70,600,173,836,247,861,1376,1092,1112,8,2020
860,Total TARA ,286662,140435,146227,94924,191738,3.3,3.54,3.09,101937,56804,45133,184725,83631,101094,23244,43984,77331,72743,4479,46442,18439,41618,14461,48526,76147,54423,51487,8,2020
861, ALBA,6453,3133,3320,2949,3504,3.83,4.03,3.66,2520,1369,1151,3933,1764,2169,695,696,1644,1762,66,1155,435,905,388,1240,1754,1142,1024,9,2020
862, ARAD,4772,2784,1988,2800,1972,2.25,2.99,1.67,2259,1343,916,2513,1441,1072,350,523,802,1821,106,688,482,1092,244,698,1182,866,690,9,2020
863, ARGES,10070,5143,4927,4272,5798,3.89,4.26,3.57,2464,1541,923,7606,3602,4004,654,1885,2924,2212,154,1632,609,1057,573,1895,2779,2095,1671,9,2020
864, BACAU,10825,4721,6104,2813,8012,5.08,5.05,5.1,3011,1337,1674,7814,3384,4430,1511,3090,760,1536,1792,1761,375,1595,558,1619,2695,2040,2318,9,2020
865, BIHOR,5317,3205,2112,3290,2027,2.01,2.63,1.48,1876,1203,673,3441,2002,1439,242,818,1209,1575,104,768,601,727,333,1068,1520,961,708,9,2020
866, BISTRITA NASAUD,4062,2280,1782,2200,1862,3.16,3.92,2.53,1484,905,579,2578,1375,1203,95,301,1153,1037,406,803,267,677,239,686,1005,747,708,9,2020
867, BOTOSANI,3933,1958,1975,1178,2755,2.86,2.99,2.75,1508,831,677,2425,1127,1298,198,1090,823,968,71,616,167,660,120,542,982,741,888,9,2020
868, BRAILA,4874,2122,2752,929,3945,3.99,3.84,4.11,1412,793,619,3462,1329,2133,809,1149,1570,576,60,547,163,586,238,765,1347,845,1093,9,2020
869, BRASOV,6831,3284,3547,2238,4593,2.6,2.91,2.36,2853,1547,1306,3978,1737,2241,1019,1176,1441,1600,104,862,629,1104,397,1395,1648,1156,1131,9,2020
870, BUZAU,11953,5085,6868,2226,9727,6.96,6.36,7.49,2481,1285,1196,9472,3800,5672,2259,2224,3632,1848,84,1729,177,1359,456,1917,3307,2328,2586,9,2020
871, CALARASI,3714,1950,1764,947,2767,4.07,4.42,3.74,1089,607,482,2625,1343,1282,362,973,998,758,35,429,159,524,131,712,957,692,698,9,2020
872, CARAS-SEVERIN,3771,1786,1985,1638,2133,3.54,3.79,3.34,1713,847,866,2058,939,1119,201,719,769,1254,111,491,226,653,200,567,944,672,735,9,2020
873, CLUJ,6595,3679,2916,3084,3511,1.77,2.23,1.4,3093,1918,1175,3502,1761,1741,587,617,1468,1792,180,1278,673,465,316,1250,1932,1734,898,9,2020
874, CONSTANTA,7017,3827,3190,2270,4747,2.38,2.99,1.92,3532,2130,1402,3485,1697,1788,844,742,1289,2664,84,727,667,1705,308,1132,1439,1141,1292,9,2020
875, COVASNA,4290,2209,2081,1294,2996,5,5.4,4.63,1535,858,677,2755,1351,1404,551,1163,893,914,63,557,149,972,289,839,1062,595,533,9,2020
876, DAMBOVITA,6083,2962,3121,1669,4414,3.16,3.6,2.83,1145,632,513,4938,2330,2608,569,615,1914,1531,106,983,365,948,324,973,1498,1174,1166,9,2020
877, DOLJ,17707,7742,9965,3091,14616,6.65,6.4,6.86,3242,1868,1374,14465,5874,8591,758,5832,4515,3975,379,1927,321,1847,858,2969,5010,3491,3532,9,2020
878, GALATI,12027,5345,6682,2291,9736,6.33,6.23,6.41,2781,1580,1201,9246,3765,5481,1175,2077,4346,2118,152,1692,467,1628,404,1652,3344,2456,2543,9,2020
879, GIURGIU,2153,1175,978,757,1396,2.68,3.17,2.26,590,363,227,1563,812,751,258,304,655,674,19,166,77,488,70,294,453,415,433,9,2020
880, GORJ,4979,2422,2557,2138,2841,3.68,3.86,3.53,1632,945,687,3347,1477,1870,174,476,1005,1626,329,992,377,701,238,788,1277,957,1018,9,2020
881, HARGHITA,5517,2883,2634,2304,3213,4.08,4.85,3.48,1946,1106,840,3571,1777,1794,1019,915,1046,1271,89,862,315,1125,299,1144,1370,851,728,9,2020
882, HUNEDOARA,6009,3381,2628,3935,2074,3.5,4.21,2.88,4331,2519,1812,1678,862,816,205,301,1299,2243,126,1194,641,738,374,822,1870,1406,799,9,2020
883, IALOMITA,4294,2008,2286,1039,3255,4.58,4.64,4.53,1417,747,670,2877,1261,1616,276,1047,1324,881,66,619,81,597,177,663,1137,792,928,9,2020
884, IASI,9078,4289,4789,1933,7145,3.05,3.08,3.03,1880,1057,823,7198,3232,3966,535,1636,2784,1131,89,2326,577,923,250,1324,2523,1838,2220,9,2020
885, ILFOV,922,551,371,460,462,0.44,0.62,0.31,267,158,109,655,393,262,79,121,122,416,8,97,79,322,35,140,199,131,95,9,2020
886, MARAMURES,5008,2466,2542,1923,3085,2.48,2.65,2.34,3002,1469,1533,2006,997,1009,74,900,686,1956,117,831,444,1882,307,681,924,708,506,9,2020
887, MEHEDINTI,6329,2876,3453,1704,4625,6.2,6.05,6.34,1721,953,768,4608,1923,2685,0,1242,2794,1227,90,837,139,595,358,1310,2051,930,1085,9,2020
888, MURES,15343,8200,7143,4881,10462,1.24,1.34,1.15,1836,1031,805,4074,1893,2181,24,144,2519,5234,298,2802,4322,397,1437,3641,4427,3042,2399,9,2020
889, NEAMT,5910,2924,2986,2131,3779,2.51,2.78,2.29,1803,1052,751,6567,2947,3620,640,1536,1097,1220,120,895,402,1212,378,1128,1420,971,801,9,2020
890, OLT,8370,3999,4371,2308,6062,4.6,4.81,4.42,2400,1402,998,7060,3018,4042,903,1075,2310,1641,124,2004,313,1218,330,1259,2232,1638,1693,9,2020
891, PRAHOVA,9460,4420,5040,1981,7479,5.87,5.97,5.78,3534,2035,1499,5537,2790,2747,1896,714,2812,2310,170,1474,84,1340,311,1271,2530,2000,2008,9,2020
892, SALAJ,9071,4825,4246,4561,4510,3.12,3.91,2.53,1336,796,540,3918,1706,2212,532,1121,2101,2446,290,1816,765,1228,384,1522,2491,2039,1407,9,2020
893, Satu M.,5254,2502,2752,1700,3554,5.08,5.52,4.74,1188,624,564,4035,1836,2199,111,1235,1113,1443,131,981,240,966,317,1060,1318,873,720,9,2020
894, SIBIU,5223,2460,2763,938,4285,3.57,3.65,3.5,2351,1296,1055,3009,1414,1595,286,1966,1310,589,57,846,169,790,354,1189,1452,653,785,9,2020
895, SUCEAVA,5360,2710,2650,2622,2738,2.73,3.17,2.39,3764,1984,1780,7836,3640,4196,404,1273,1010,1161,101,946,465,737,315,1019,1414,1025,850,9,2020
896, TELEORMAN,11600,5624,5976,4487,7113,5.01,5.3,4.76,1958,1094,864,6010,2608,3402,209,1771,2696,3220,477,2661,566,2858,630,1883,2753,1683,1793,9,2020
897, TIMIS,7968,3702,4266,1893,6075,5.68,5.4,5.93,2279,1342,937,2010,1120,890,334,802,4064,1401,95,1209,63,1082,380,1315,2073,1571,1547,9,2020
898, TULCEA,4289,2462,1827,2825,1464,1.22,1.59,0.93,781,467,314,1697,809,888,206,370,637,1539,115,756,666,656,242,761,1086,835,709,9,2020
899, VALCEA,2478,1276,1202,830,1648,2.99,3.3,2.73,2480,1362,1118,3812,1819,1993,0,410,860,634,0,480,94,521,300,418,553,421,265,9,2020
900, VASLUI,6292,3181,3111,2696,3596,3.9,4.41,3.49,1777,1008,769,6894,2821,4073,53,796,1174,2268,286,1266,449,1276,292,858,1571,1321,974,9,2020
901, VRANCEA,8671,3829,4842,1549,7122,6.5,5.92,7.04,1215,649,566,4207,1800,2407,271,1383,3176,1178,86,2459,118,838,253,1259,2597,1932,1792,9,2020
902,BUCURESTI,5422,2449,2973,1191,4231,3.98,3.84,4.1,15343,8200,7143,0,0,0,101,1673,1323,871,362,921,171,831,238,847,1353,1073,1080,9,2020
903,Total TARA ,285294,139829,145465,93965,191329,3.26,3.49,3.07,100829,56253,44576,184465,83576,100889,21469,48901,72067,68521,7702,48085,18549,41825,14645,48515,75479,53981,50849,9,2020
904, ALBA,6391,3118,3273,2814,3577,3.79,4.01,3.6,2515,1362,1153,3876,1756,2120,704,678,1605,1743,67,1131,463,973,378,1208,1687,1144,1001,10,2020
905, ARAD,4675,2706,1969,2697,1978,2.21,2.91,1.66,2233,1317,916,2442,1389,1053,336,328,965,1804,98,649,495,1091,234,680,1139,848,683,10,2020
906, ARGES,9382,4823,4559,4163,5219,3.62,3.99,3.3,2383,1495,888,6999,3328,3671,597,1675,2733,2071,141,1580,585,944,543,1727,2591,2002,1575,10,2020
907, BACAU,11121,4825,6296,2854,8267,5.22,5.16,5.26,2957,1279,1678,8164,3546,4618,1560,3201,734,1546,1806,1849,425,1676,777,1644,2561,2039,2424,10,2020
908, BIHOR,5524,3246,2278,3183,2341,2.09,2.67,1.6,1904,1199,705,3620,2047,1573,272,978,1281,1514,104,771,604,741,349,1102,1543,1019,770,10,2020
909, BISTRITA NASAUD,4131,2295,1836,2231,1900,3.21,3.95,2.61,1505,890,615,2626,1405,1221,144,231,1215,1410,104,761,266,695,250,710,1007,749,720,10,2020
910, BOTOSANI,3917,1965,1952,1172,2745,2.85,3,2.71,1473,826,647,2444,1139,1305,194,1067,898,883,82,625,168,646,125,529,1001,721,895,10,2020
911, BRAILA,4906,2100,2806,929,3977,4.01,3.8,4.19,1349,754,595,3557,1346,2211,832,1198,1572,557,63,515,169,591,232,781,1381,833,1088,10,2020
912, BRASOV,6704,3197,3507,2170,4534,2.55,2.84,2.34,2798,1512,1286,3906,1685,2221,1039,1120,1470,1525,105,827,618,1087,405,1371,1633,1133,1075,10,2020
913, BUZAU,11824,5018,6806,2200,9624,6.89,6.27,7.42,2441,1268,1173,9383,3750,5633,2264,2143,3644,1799,87,1711,176,1321,486,1915,3246,2329,2527,10,2020
914, CALARASI,3730,1944,1786,900,2830,4.09,4.41,3.78,1085,598,487,2645,1346,1299,469,805,1091,786,36,427,116,525,140,722,947,694,702,10,2020
915, CARAS-SEVERIN,3602,1704,1898,1588,2014,3.38,3.62,3.2,1585,779,806,2017,925,1092,539,353,403,971,303,802,231,583,195,556,922,669,677,10,2020
916, CLUJ,6308,3557,2751,2992,3316,1.69,2.16,1.32,3143,1957,1186,3165,1600,1565,587,617,1367,1678,189,1094,776,482,330,1339,1789,1470,898,10,2020
917, CONSTANTA,7870,4552,3318,2926,4944,2.67,3.55,1.99,4187,2651,1536,3683,1901,1782,697,659,1755,2915,112,1011,721,1780,321,1216,1779,1385,1389,10,2020
918, COVASNA,4373,2233,2140,1275,3098,5.1,5.46,4.77,1513,841,672,2860,1392,1468,592,1227,935,872,65,549,133,957,299,877,1084,594,562,10,2020
919, DAMBOVITA,6257,3066,3191,1691,4566,3.25,3.73,2.89,1151,643,508,5106,2423,2683,581,728,1918,1528,129,998,375,952,344,1025,1529,1172,1235,10,2020
920, DOLJ,17456,7675,9781,3176,14280,6.56,6.34,6.74,3231,1868,1363,14225,5807,8418,747,5851,4364,3885,377,1903,329,1858,882,2934,4900,3472,3410,10,2020
921, GALATI,11677,5189,6488,2152,9525,6.15,6.05,6.23,2673,1501,1172,9004,3688,5316,1105,2010,4252,2029,137,1659,485,1621,415,1623,3280,2375,2363,10,2020
922, GIURGIU,2097,1140,957,740,1357,2.61,3.07,2.21,531,324,207,1566,816,750,265,309,683,584,20,160,76,426,68,305,463,411,424,10,2020
923, GORJ,5159,2463,2696,2152,3007,3.82,3.93,3.72,1640,951,689,3519,1512,2007,260,245,821,1666,328,1460,379,722,268,794,1355,972,1048,10,2020
924, HARGHITA,6108,3141,2967,2348,3760,4.52,5.28,3.92,1991,1148,843,4117,1993,2124,1237,1140,1165,1297,78,878,313,1189,344,1270,1540,954,811,10,2020
925, HUNEDOARA,5963,3365,2598,3689,2274,3.47,4.19,2.85,4180,2456,1724,1783,909,874,343,295,1340,2093,129,1124,639,812,332,954,1670,1386,809,10,2020
926, IALOMITA,4073,1897,2176,1018,3055,4.34,4.38,4.31,1412,738,674,2661,1159,1502,246,1009,1205,856,64,615,78,581,169,612,1100,764,847,10,2020
927, IASI,9026,4215,4811,1968,7058,3.04,3.02,3.05,1874,1038,836,7152,3177,3975,544,1679,2778,1076,99,2288,562,895,241,1283,2552,1839,2216,10,2020
928, ILFOV,1423,876,547,946,477,0.69,0.99,0.46,357,228,129,1066,648,418,100,162,239,570,18,194,140,373,120,236,296,213,185,10,2020
929, MARAMURES,5042,2510,2532,2022,3020,2.5,2.7,2.33,2939,1452,1487,2103,1058,1045,68,757,781,1923,141,880,492,1807,337,715,973,718,492,10,2020
930, MEHEDINTI,6227,2831,3396,1717,4510,6.1,5.96,6.23,1790,967,823,4437,1864,2573,0,1211,2727,1232,99,820,138,604,338,1286,2029,909,1061,10,2020
931, MURES,15317,8220,7097,4793,10524,1.24,1.34,1.14,1864,1041,823,4135,1918,2217,24,136,2513,5226,302,2797,4319,390,1417,3643,4434,3053,2380,10,2020
932, NEAMT,5999,2959,3040,2100,3899,2.55,2.82,2.33,1684,1000,684,6185,2809,3376,665,1626,1079,1213,122,899,395,1192,387,1156,1459,987,818,10,2020
933, OLT,7869,3809,4060,2432,5437,4.32,4.58,4.11,2328,1447,881,7004,2924,4080,859,980,2114,1606,108,1884,318,1165,331,1243,2071,1505,1554,10,2020
934, PRAHOVA,9332,4371,4961,2118,7214,5.79,5.91,5.69,3442,1990,1452,5493,2788,2705,1917,700,2764,2251,185,1434,81,1300,314,1286,2508,1967,1957,10,2020
935, SALAJ,8935,4778,4157,4466,4469,3.07,3.87,2.48,1317,787,530,3936,1734,2202,526,1088,2107,2436,275,1773,730,1189,375,1540,2447,2023,1361,10,2020
936, Satu M.,5253,2521,2732,1700,3553,5.08,5.57,4.7,1155,599,556,4125,1872,2253,361,1140,1321,1429,84,655,263,935,318,1073,1314,891,722,10,2020
937, SIBIU,5280,2471,2809,958,4322,3.61,3.67,3.56,2215,1232,983,2992,1394,1598,627,1993,1475,583,31,412,159,793,357,1194,1470,665,801,10,2020
938, SUCEAVA,5207,2626,2581,2440,2767,2.65,3.07,2.33,3801,2019,1782,8233,3796,4437,392,1150,1149,1104,104,871,437,669,302,1006,1384,997,849,10,2020
939, TELEORMAN,12034,5815,6219,4588,7446,5.2,5.48,4.96,1946,1072,874,6435,2735,3700,486,2044,2871,3539,218,2298,578,2917,650,2014,2858,1734,1861,10,2020
940, TIMIS,8381,3807,4574,1790,6591,5.97,5.56,6.36,2121,1261,860,1934,1055,879,357,846,4130,1340,119,1520,69,1119,444,1423,2226,1588,1581,10,2020
941, TULCEA,4055,2316,1739,2714,1341,1.16,1.5,0.89,849,507,342,1748,826,922,206,113,494,1419,126,1036,661,586,245,738,1027,782,677,10,2020
942, VALCEA,2597,1333,1264,774,1823,3.14,3.44,2.87,2297,1289,1008,3612,1707,1905,0,426,1026,673,0,374,98,505,130,374,680,534,374,10,2020
943, VASLUI,5909,2996,2913,2643,3266,3.66,4.15,3.27,1716,990,726,7295,2998,4297,122,465,1016,2026,290,1599,391,1103,252,843,1522,1241,948,10,2020
944, VRANCEA,9011,3988,5023,1552,7459,6.75,6.16,7.3,1229,636,593,4357,1867,2490,303,1470,3009,1171,92,2837,129,852,303,1331,2803,1954,1768,10,2020
945,BUCURESTI,5586,2503,3083,1188,4398,4.1,3.92,4.25,15317,8220,7097,0,0,0,289,1317,1897,1222,78,605,178,825,256,870,1393,1124,1118,10,2020
946,Total TARA ,285731,140164,145567,93969,191762,3.27,3.5,3.07,100121,56132,43989,185610,84032,101578,23456,47170,72906,68051,7115,48275,18758,41472,15003,49148,75593,53859,50656,10,2020
947, ALBA,6429,3139,3290,2729,3700,3.82,4.04,3.62,2461,1340,1121,3968,1799,2169,796,735,1585,1693,68,1105,447,961,391,1247,1691,1157,982,11,2020
948, ARAD,4582,2672,1910,2611,1971,2.16,2.87,1.61,2196,1307,889,2386,1365,1021,340,479,786,1764,89,631,493,1069,217,675,1106,851,664,11,2020
949, ARGES,9719,4967,4752,4055,5664,3.75,4.11,3.44,2307,1462,845,7412,3505,3907,633,1890,2902,2020,137,1569,568,922,561,1821,2720,2066,1629,11,2020
950, BACAU,11165,4780,6385,2832,8333,5.24,5.11,5.33,3001,1234,1767,8164,3546,4618,1560,3190,734,1568,1831,1841,441,1688,800,1666,2563,2054,2394,11,2020
951, BIHOR,5833,3392,2441,3293,2540,2.21,2.78,1.71,1973,1258,715,3860,2134,1726,302,1069,1392,1540,107,808,615,749,372,1196,1651,1068,797,11,2020
952, BISTRITA NASAUD,4098,2251,1847,2279,1819,3.19,3.87,2.62,1502,886,616,2596,1365,1231,133,218,1223,1384,94,770,276,678,258,727,1003,737,695,11,2020
953, BOTOSANI,3898,1904,1994,1206,2692,2.84,2.91,2.77,1453,791,662,2445,1113,1332,207,1080,901,865,69,605,171,610,135,518,967,738,930,11,2020
954, BRAILA,5061,2174,2887,962,4099,4.14,3.94,4.31,1370,762,608,3691,1412,2279,880,1237,1602,569,64,538,171,614,238,825,1421,861,1102,11,2020
955, BRASOV,7050,3340,3710,2131,4919,2.68,2.96,2.47,2869,1548,1321,4181,1792,2389,1097,1242,1574,1512,112,878,635,1127,438,1463,1709,1181,1132,11,2020
956, BUZAU,12378,5165,7213,2538,9840,7.21,6.46,7.87,2585,1300,1285,9793,3865,5928,2357,2180,3771,1856,127,1897,190,1334,505,1977,3458,2479,2625,11,2020
957, CALARASI,3809,1938,1871,958,2851,4.17,4.39,3.96,1075,585,490,2734,1353,1381,364,951,1107,775,34,469,109,523,145,727,995,714,705,11,2020
958, CARAS-SEVERIN,3758,1767,1991,1616,2142,3.53,3.75,3.35,1650,812,838,2108,955,1153,585,437,469,1165,115,745,242,591,189,601,961,693,723,11,2020
959, CLUJ,6003,3376,2627,2976,3027,1.61,2.05,1.26,2971,1876,1095,3032,1500,1532,492,616,1378,1587,169,1031,730,777,349,1152,1536,1250,939,11,2020
960, CONSTANTA,8629,5063,3566,3543,5086,2.93,3.95,2.14,4560,2941,1619,4069,2122,1947,785,730,1851,3115,124,1275,749,1790,344,1326,2030,1586,1553,11,2020
961, COVASNA,4492,2266,2226,1270,3222,5.24,5.54,4.96,1482,811,671,3010,1455,1555,610,1282,994,865,64,539,138,963,317,916,1134,596,566,11,2020
962, DAMBOVITA,6236,3063,3173,1727,4509,3.24,3.73,2.88,1175,637,538,5061,2426,2635,575,700,1929,1518,126,1018,370,893,346,1030,1548,1188,1231,11,2020
963, DOLJ,18343,7964,10379,3185,15158,6.89,6.58,7.15,3203,1845,1358,15140,6119,9021,787,6116,4729,3933,365,2081,332,1907,951,3097,5207,3637,3544,11,2020
964, GALATI,12092,5306,6786,2215,9877,6.36,6.18,6.51,2693,1489,1204,9399,3817,5582,1148,2135,4387,2019,144,1743,516,1633,436,1692,3418,2432,2481,11,2020
965, GIURGIU,2169,1194,975,778,1391,2.7,3.22,2.25,557,346,211,1612,848,764,271,315,701,612,23,168,79,418,69,347,480,413,442,11,2020
966, GORJ,5325,2469,2856,2187,3138,3.94,3.94,3.94,1713,946,767,3612,1523,2089,279,455,1009,1804,208,1179,391,736,291,826,1380,1001,1091,11,2020
967, HARGHITA,6504,3386,3118,2671,3833,4.81,5.69,4.12,2135,1256,879,4369,2130,2239,1291,1172,1264,1401,78,980,318,1179,367,1356,1664,1068,870,11,2020
968, HUNEDOARA,5925,3302,2623,3594,2331,3.45,4.11,2.87,4077,2380,1697,1848,922,926,343,295,1340,2055,129,1124,639,786,325,952,1663,1363,836,11,2020
969, IALOMITA,4237,1992,2245,1180,3057,4.52,4.6,4.45,1422,776,646,2815,1216,1599,245,1009,1283,868,62,683,87,560,188,626,1172,835,856,11,2020
970, IASI,9132,4242,4890,1988,7144,3.07,3.04,3.1,1921,1060,861,7211,3182,4029,558,1705,2836,1089,90,2309,545,897,245,1329,2576,1859,2226,11,2020
971, ILFOV,1450,888,562,968,482,0.7,1,0.47,384,240,144,1066,648,418,105,163,239,568,18,195,162,354,134,260,308,212,182,11,2020
972, MARAMURES,4999,2495,2504,2099,2900,2.48,2.68,2.3,2897,1435,1462,2102,1060,1042,61,758,757,1940,148,870,465,1675,263,771,1058,784,448,11,2020
973, MEHEDINTI,6238,2833,3405,1691,4547,6.12,5.96,6.25,1766,956,810,4472,1877,2595,0,1220,2746,1229,98,809,136,601,352,1277,2033,914,1061,11,2020
974, MURES,15287,8209,7078,4684,10603,1.24,1.34,1.14,1943,1036,907,4159,1913,2246,23,140,2512,5209,306,2775,4322,361,1408,3665,4423,3050,2380,11,2020
975, NEAMT,6102,2949,3153,2145,3957,2.59,2.81,2.41,1733,989,744,5989,2677,3312,699,1718,1134,1175,91,901,384,1116,404,1199,1538,1023,822,11,2020
976, OLT,7722,3666,4056,2326,5396,4.24,4.41,4.11,2328,1357,971,7063,3041,4022,703,1001,2073,1624,100,1867,354,1172,336,1209,2003,1480,1522,11,2020
977, PRAHOVA,9391,4398,4993,2212,7179,5.83,5.94,5.73,3350,1952,1398,5320,2683,2637,1928,2506,303,2201,187,2176,90,1257,334,1295,2576,1959,1970,11,2020
978, SALAJ,8670,4635,4035,4454,4216,2.98,3.76,2.41,1288,760,528,4011,1762,2249,533,1024,2071,2368,252,1717,705,1157,366,1497,2395,1967,1288,11,2020
979, Satu M.,5299,2522,2777,1692,3607,5.12,5.57,4.78,1157,604,553,4212,1928,2284,345,1170,1390,1402,87,653,252,947,319,1079,1330,891,733,11,2020
980, SIBIU,5369,2532,2837,990,4379,3.67,3.76,3.6,2154,1209,945,3029,1413,1616,637,1560,1292,583,34,1102,161,803,362,1198,1511,672,823,11,2020
981, SUCEAVA,5183,2622,2561,2390,2793,2.64,3.06,2.31,3857,2033,1824,8273,3768,4505,395,1364,966,1047,95,867,449,608,321,1025,1379,989,861,11,2020
982, TELEORMAN,12130,5801,6329,4669,7461,5.24,5.47,5.04,1924,1048,876,7019,2859,4160,492,1590,3360,3555,218,2357,558,2918,649,1969,2887,1768,1939,11,2020
983, TIMIS,8943,3907,5036,1791,7152,6.37,5.7,7,2104,1247,857,2025,1092,933,408,1029,4704,1244,107,1392,59,1056,415,1436,2334,1835,1867,11,2020
984, TULCEA,4129,2339,1790,2847,1282,1.18,1.51,0.91,787,466,321,1845,838,1007,251,120,859,1388,98,742,671,548,247,741,1047,829,717,11,2020
985, VALCEA,2632,1304,1328,829,1803,3.18,3.37,3.01,2200,1225,975,3618,1712,1906,0,435,1102,620,0,389,86,405,123,424,696,579,405,11,2020
986, VASLUI,5818,2937,2881,2686,3132,3.61,4.07,3.23,1714,1007,707,7116,2898,4218,122,641,1087,2024,161,1376,407,1106,251,832,1471,1266,892,11,2020
987, VRANCEA,8830,3905,4925,1702,7128,6.61,6.04,7.16,1222,622,600,4395,1870,2525,286,1443,3037,1134,89,2714,127,848,309,1360,2720,1897,1696,11,2020
988,BUCURESTI,5617,2492,3125,1204,4413,4.12,3.91,4.3,15287,8209,7078,0,0,0,302,1370,1907,1169,83,619,167,802,272,903,1406,1127,1107,11,2020
989,Total TARA ,290676,141546,149130,95903,194773,3.32,3.53,3.15,100446,56043,44403,190230,85503,104727,23928,50490,73286,68057,6601,49507,18807,41139,15342,50232,77168,55069,51726,11,2020
990, ALBA,6350,3053,3297,2725,3625,3.77,3.93,3.63,2408,1289,1119,3942,1764,2178,822,723,1558,1620,67,1130,430,927,367,1236,1676,1153,991,12,2020
991, ARAD,4572,2631,1941,2735,1837,2.16,2.83,1.63,2181,1295,886,2391,1336,1055,343,319,962,1701,89,644,514,991,208,681,1138,884,670,12,2020
992, ARGES,9840,4935,4905,4185,5655,3.8,4.09,3.55,2285,1420,865,7555,3515,4040,658,1928,2955,1973,141,1634,551,857,536,1811,2786,2134,1716,12,2020
993, BACAU,11505,4867,6638,2982,8523,5.4,5.21,5.55,2976,1224,1752,8529,3643,4886,1563,3209,801,1612,1882,1965,473,1514,675,1775,2729,2292,2520,12,2020
994, BIHOR,5965,3440,2525,3425,2540,2.26,2.82,1.77,2000,1285,715,3965,2155,1810,318,1114,1474,1496,97,855,611,722,353,1229,1705,1118,838,12,2020
995, BISTRITA NASAUD,4375,2313,2062,2490,1885,3.4,3.98,2.93,1523,888,635,2852,1425,1427,164,252,1372,1424,86,805,272,673,270,773,1095,817,747,12,2020
996, BOTOSANI,4007,1887,2120,1302,2705,2.92,2.89,2.95,1459,771,688,2548,1116,1432,218,1138,949,820,63,655,164,570,138,549,1028,774,948,12,2020
997, BRAILA,5263,2220,3043,1106,4157,4.31,4.02,4.54,1408,774,634,3855,1446,2409,883,1276,1683,586,68,589,178,613,236,849,1501,916,1148,12,2020
998, BRASOV,6714,3146,3568,2152,4562,2.56,2.79,2.38,2686,1432,1254,4028,1714,2314,1089,1252,1540,1282,107,833,611,927,430,1413,1683,1166,1095,12,2020
999, BUZAU,13468,5529,7939,2663,10805,7.84,6.91,8.66,2646,1324,1322,10822,4205,6617,2541,2462,4158,1949,146,2012,200,1321,527,2149,3826,2759,2886,12,2020
1000, CALARASI,3890,1889,2001,1090,2800,4.26,4.28,4.24,1039,559,480,2851,1330,1521,363,852,1140,790,32,613,100,499,140,744,1029,761,717,12,2020
1001, CARAS-SEVERIN,3607,1695,1912,1662,1945,3.39,3.6,3.22,1560,776,784,2047,919,1128,554,368,753,1109,116,486,221,492,161,581,953,701,719,12,2020
1002, CLUJ,6108,3379,2729,3038,3070,1.64,2.05,1.31,2986,1876,1110,3122,1503,1619,492,743,1362,1450,177,1122,762,736,372,1204,1571,1241,984,12,2020
1003, CONSTANTA,8732,5154,3578,3829,4903,2.96,4.02,2.15,4470,2967,1503,4262,2187,2075,827,1006,2047,2686,121,1337,708,1193,358,1404,2268,1781,1728,12,2020
1004, COVASNA,4348,2124,2224,1182,3166,5.07,5.19,4.95,1369,738,631,2979,1386,1593,613,1347,973,769,53,471,122,927,306,901,1088,574,552,12,2020
1005, DAMBOVITA,6182,3008,3174,1764,4418,3.21,3.66,2.88,1182,643,539,5000,2365,2635,562,653,1940,1512,118,1027,370,886,338,1029,1534,1166,1229,12,2020
1006, DOLJ,18872,8175,10697,3359,15513,7.09,6.76,7.37,3206,1851,1355,15666,6324,9342,814,6324,4905,4237,340,1923,329,1870,975,3205,5360,3781,3681,12,2020
1007, GALATI,12190,5257,6933,2415,9775,6.42,6.13,6.65,2627,1438,1189,9563,3819,5744,1201,2452,4482,1897,124,1537,497,1506,430,1728,3511,2485,2530,12,2020
1008, GIURGIU,2098,1140,958,820,1278,2.61,3.07,2.21,509,320,189,1589,820,769,268,319,726,505,21,182,77,338,73,318,487,434,448,12,2020
1009, GORJ,5212,2387,2825,2193,3019,3.86,3.81,3.9,1645,917,728,3567,1470,2097,281,255,1302,1780,187,1041,366,679,283,815,1371,995,1069,12,2020
1010, HARGHITA,6162,3189,2973,2926,3236,4.56,5.36,3.93,1978,1181,797,4184,2008,2176,1270,748,1337,1390,75,1051,291,1086,342,1337,1603,920,874,12,2020
1011, HUNEDOARA,5736,3156,2580,3692,2044,3.34,3.93,2.83,3927,2271,1656,1809,885,924,343,245,1340,1862,129,1228,589,734,299,922,1584,1349,848,12,2020
1012, IALOMITA,4581,2054,2527,1448,3133,4.88,4.74,5,1450,756,694,3131,1298,1833,264,1114,1438,909,61,715,80,551,192,681,1298,950,909,12,2020
1013, IASI,9356,4347,5009,2084,7272,3.15,3.12,3.17,1915,1047,868,7441,3300,4141,583,1772,2944,1061,86,2380,530,881,254,1375,2658,1911,2277,12,2020
1014, ILFOV,1441,884,557,980,461,0.69,1,0.47,375,236,139,1066,648,418,105,142,239,563,18,195,179,349,134,256,308,212,182,12,2020
1015, MARAMURES,4697,2313,2384,2180,2517,2.33,2.49,2.19,2624,1310,1314,2073,1003,1070,62,695,764,1738,151,856,431,1431,289,768,1009,727,473,12,2020
1016, MEHEDINTI,6503,2899,3604,1889,4614,6.38,6.1,6.61,1871,985,886,4632,1914,2718,0,1245,2810,1326,109,860,153,628,396,1328,2085,962,1104,12,2020
1017, MURES,15251,8167,7084,4697,10554,1.24,1.33,1.14,1911,1012,899,4512,2024,2488,24,140,2520,5183,308,2788,4288,356,1380,3680,4397,3066,2372,12,2020
1018, NEAMT,6423,3036,3387,2231,4192,2.73,2.89,2.59,1816,1043,773,7218,3188,4030,710,1999,1269,1144,92,860,349,1120,396,1287,1681,1069,870,12,2020
1019, OLT,9034,4231,4803,2588,6446,4.96,5.09,4.86,2240,1258,982,7201,3036,4165,536,1589,2589,2284,99,1605,332,1172,352,1405,2443,1823,1839,12,2020
1020, PRAHOVA,9441,4294,5147,2301,7140,5.86,5.8,5.9,3238,1886,1352,5333,2650,2683,1973,725,2864,2231,180,1383,85,1088,320,1323,2634,2029,2047,12,2020
1021, SALAJ,8571,4536,4035,4501,4070,2.95,3.68,2.41,1322,759,563,4097,1778,2319,535,1043,2100,2275,236,1709,673,1064,345,1458,2387,1979,1338,12,2020
1022, Satu M.,5419,2537,2882,1820,3599,5.24,5.6,4.96,1143,595,548,4315,1953,2362,370,1485,1423,1109,83,689,260,925,309,1129,1372,935,749,12,2020
1023, SIBIU,5458,2548,2910,1083,4375,3.73,3.78,3.69,2169,1200,969,3327,1513,1814,646,2104,1540,558,31,425,154,780,373,1228,1553,690,834,12,2020
1024, SUCEAVA,5496,2713,2783,2414,3082,2.8,3.17,2.51,3698,1909,1789,8106,3574,4532,467,1383,1239,1020,93,851,443,605,334,1110,1483,1051,913,12,2020
1025, TELEORMAN,11804,5483,6321,4929,6875,5.1,5.17,5.04,1924,1012,912,7227,2895,4332,951,1585,2942,3238,201,2340,547,2598,616,1957,2896,1777,1960,12,2020
1026, TIMIS,9151,3907,5244,1875,7276,6.52,5.7,7.29,2280,1367,913,2166,1167,999,447,1068,4804,1360,114,1290,68,957,418,1496,2447,1939,1894,12,2020
1027, TULCEA,4446,2534,1912,2892,1554,1.27,1.64,0.98,698,416,282,1822,787,1035,342,210,877,1429,120,774,694,602,248,810,1131,898,757,12,2020
1028, VALCEA,2520,1203,1317,992,1528,3.04,3.11,2.99,2059,1123,936,3736,1718,2018,0,425,1039,634,0,349,73,340,160,408,703,519,390,12,2020
1029, VASLUI,5795,2841,2954,2860,2935,3.59,3.93,3.32,1775,1020,755,7995,3218,4777,126,538,1574,1909,143,1118,387,966,221,844,1479,1306,979,12,2020
1030, VRANCEA,9770,4238,5532,1946,7824,7.32,6.55,8.04,1202,607,595,4496,1855,2641,329,1658,3582,1905,89,2079,128,841,329,1466,3065,2175,1894,12,2020
1031,BUCURESTI,5698,2462,3236,1295,4403,4.18,3.86,4.46,15251,8167,7084,0,0,0,329,1449,1943,1110,78,623,166,765,274,916,1443,1170,1130,12,2020
1032,Total TARA ,296051,141801,154250,100740,195311,3.38,3.54,3.25,99031,54947,44084,197020,86854,110166,24986,51354,80259,67436,6531,47029,18456,38080,15157,51578,79998,57389,53849,12,2020
